ID,Total_Amount,Total_Purchase,Web_Purchase,Store_Purchase,Accepted_Campaigns,Website_Visit,Complaint,Response
1826,1190,14,4,10,0,1,0,1
1,577,17,7,10,1,5,0,1
10476,251,10,3,7,0,2,0,0
1386,11,3,1,2,0,7,0,0
5371,91,6,3,3,1,7,0,1
7348,1192,16,4,12,0,2,0,1
4073,1215,27,10,17,1,6,0,1
1991,96,6,2,4,0,5,0,0
4047,544,17,6,11,0,4,0,0
9477,544,17,6,11,0,4,0,0
2079,1208,21,5,16,0,1,0,0
5642,222,10,3,7,0,4,0,0
10530,1156,15,3,12,0,1,0,1
2964,72,4,1,3,0,6,0,0
10311,359,25,25,0,0,1,0,0
837,174,8,2,6,0,4,0,0
10521,174,8,2,6,0,4,0,1
10175,22,4,1,3,0,4,0,0
1473,72,5,2,3,0,8,0,0
2795,13,3,1,2,0,7,0,0
2285,335,12,5,7,0,7,0,0
115,393,14,5,9,0,5,0,0
10470,92,6,2,4,0,4,0,0
4065,404,14,5,9,0,7,0,0
10968,704,22,8,14,0,6,0,0
5985,122,7,2,5,0,7,0,0
5430,684,19,9,10,0,8,0,0
8432,684,19,9,10,0,8,0,0
453,45,5,2,3,0,5,0,0
9687,726,15,5,10,0,2,0,0
8890,272,11,5,6,0,6,0,0
9264,1638,21,4,17,0,2,0,0
5824,8,3,1,2,0,6,0,0
5794,446,15,7,8,2,8,0,1
3068,43,5,2,3,0,7,0,0
7962,1901,11,4,7,2,1,0,1
2681,461,18,2,16,0,1,0,0
10141,20,3,0,3,0,4,0,0
3725,1688,15,2,13,4,4,0,1
3767,1008,22,5,17,0,3,0,0
5585,48,5,2,3,0,8,0,1
7030,1485,32,11,21,1,6,0,0
1524,1104,15,8,7,1,5,0,1
3657,165,8,4,4,0,8,0,0
5740,56,5,1,4,0,6,0,1
9595,1574,13,4,9,0,3,0,1
3158,39,4,1,3,0,8,0,0
5114,965,14,5,9,0,4,0,0
340,497,17,7,10,1,5,0,1
8805,371,13,7,6,0,8,0,0
1241,51,4,1,3,0,9,0,1
1402,1253,18,4,14,0,3,0,0
7264,17,3,1,2,0,8,0,0
1619,1588,16,4,12,0,1,0,1
6398,50,6,3,3,0,8,0,0
1857,83,5,2,3,0,7,0,1
4877,41,4,1,3,0,7,0,0
3066,231,10,4,6,0,5,0,0
10286,926,23,2,21,0,0,0,0
1992,893,12,2,10,1,7,0,1
4246,373,2,1,1,0,17,0,0
10623,32,4,1,3,0,5,0,0
4867,88,7,3,4,0,7,0,0
3112,24,4,1,3,0,5,0,0
4865,400,14,5,9,0,7,0,1
6287,36,4,1,3,0,6,0,1
4405,789,21,6,15,0,5,0,0
5332,1066,16,3,13,0,1,0,0
1519,73,6,3,3,0,8,0,1
9080,73,6,3,3,0,8,0,0
1772,2043,18,5,13,2,2,0,1
5341,1588,13,6,7,1,7,0,0
5510,441,13,5,8,0,5,0,0
3887,106,5,2,3,0,9,0,1
7022,1410,20,2,18,0,6,0,0
9999,1040,22,9,13,0,5,0,0
10352,117,6,3,3,0,9,0,1
7919,2092,22,10,12,0,8,0,1
4114,1693,28,6,22,0,3,0,0
7990,17,3,0,3,0,6,0,0
9888,1091,15,4,11,0,2,0,0
4399,1091,15,4,11,0,2,0,0
4452,372,13,6,7,2,7,0,1
4785,714,20,6,14,0,3,0,0
8461,16,3,1,2,0,7,0,0
3878,48,4,1,3,0,7,0,0
9612,43,4,1,3,0,7,0,0
4098,44,6,2,4,0,6,0,0
158,1196,16,8,8,1,4,0,1
3896,37,4,1,3,0,7,0,0
9970,162,8,1,7,0,2,0,0
4002,1123,26,7,19,0,3,0,0
10914,17,4,1,3,0,4,0,0
7279,1044,14,4,10,0,2,0,0
10582,758,19,5,14,0,2,0,0
4470,140,7,2,5,0,4,0,0
6183,140,7,2,5,0,4,0,0
6379,121,6,2,4,0,7,0,1
8601,1395,19,8,11,0,4,0,0
4827,455,15,4,11,0,4,0,1
6715,685,19,6,13,0,6,0,0
10676,1173,18,3,15,0,2,0,1
1041,424,14,7,7,0,8,0,1
492,424,14,7,7,0,8,0,0
11133,424,14,7,7,0,8,0,1
4491,1178,17,3,14,1,8,0,0
873,1178,17,3,14,1,8,0,1
1631,1282,19,8,11,0,6,0,1
8278,1711,15,8,7,0,5,0,0
6815,809,21,7,14,3,2,0,1
254,473,15,7,8,1,7,0,0
1349,148,7,3,4,0,6,0,0
2534,188,8,4,4,0,7,0,0
2130,147,7,3,4,0,6,0,1
2296,30,3,1,2,1,6,0,0
3799,868,20,7,13,0,5,0,0
11084,1053,15,3,12,0,7,0,1
5172,1053,15,3,12,0,7,0,0
9504,1008,24,3,21,0,1,0,1
850,757,20,6,14,0,3,0,0
4477,653,17,5,12,0,4,0,0
1945,1400,18,7,11,2,4,0,0
7685,78,6,2,4,0,5,0,0
6310,78,6,2,4,0,5,0,0
10832,467,13,6,7,0,6,0,0
3025,306,12,6,6,0,7,0,0
2404,257,10,5,5,0,7,0,0
8581,751,20,10,10,0,8,0,0
8755,1196,17,3,14,0,7,0,0
10177,1338,17,5,12,0,2,0,0
2429,1338,17,5,12,0,2,0,0
8920,1128,25,11,14,0,7,0,0
8430,22,3,0,3,0,5,0,0
8619,22,3,0,3,0,5,0,0
7233,1782,14,5,9,1,4,0,0
6678,72,7,3,4,0,7,0,0
830,1658,14,4,10,2,3,0,1
6365,80,5,2,3,0,6,0,0
6770,68,5,2,3,1,6,0,1
2261,16,3,1,2,0,7,0,0
1031,1062,25,6,19,1,2,0,0
10089,1112,28,6,22,4,2,0,1
9256,1001,23,8,15,0,6,0,0
10641,57,6,2,4,0,6,0,0
624,35,3,0,3,1,6,0,1
4211,57,5,2,3,0,7,0,0
1407,57,5,2,3,0,7,0,0
10356,32,4,1,3,0,7,0,0
9323,874,22,10,12,1,8,0,1
1146,874,22,10,12,1,8,0,1
6343,1518,22,6,16,1,2,0,0
8545,1789,16,2,14,4,1,0,1
8275,20,3,1,2,0,7,0,0
10673,1416,20,6,14,0,3,0,0
8799,153,8,3,5,0,7,0,0
67,92,6,2,4,0,7,0,0
9923,92,6,2,4,0,7,0,0
2814,31,4,1,3,0,7,0,0
2711,31,4,1,3,0,7,0,0
4320,943,22,6,16,0,3,0,0
10451,25,3,0,3,0,6,0,0
4198,25,3,0,3,0,6,0,0
10814,1376,24,6,18,0,4,0,1
944,393,13,4,9,0,4,0,0
8151,263,8,4,4,0,8,0,0
6184,1670,14,3,11,0,1,0,0
3498,877,21,7,14,1,6,0,1
2870,502,15,6,9,0,6,0,0
7342,1072,24,6,18,0,5,0,0
1911,1364,28,11,17,0,6,0,0
10862,326,12,1,11,0,2,0,0
2546,70,5,1,4,0,3,0,0
3005,1650,22,4,18,2,1,0,1
8318,1738,19,5,14,1,1,0,0
2930,1281,18,2,16,0,5,0,0
8216,325,11,4,7,0,5,0,0
1212,936,22,8,14,1,6,0,0
2541,48,5,2,3,0,8,0,0
10659,53,7,3,4,0,7,0,0
10905,252,11,4,7,0,8,0,1
8910,252,11,4,7,0,8,0,1
7349,103,7,3,4,0,8,0,1
7872,557,22,6,16,3,5,0,1
4290,24,3,1,2,0,7,0,0
7408,233,10,5,5,0,7,0,0
9986,54,7,4,3,0,7,0,1
8235,843,21,6,15,0,3,0,0
10949,1958,18,5,13,1,3,0,1
7284,20,3,1,2,0,8,0,0
9529,1627,21,3,18,1,2,0,1
9930,1167,27,6,21,0,2,0,0
10270,66,6,3,3,0,7,0,0
760,811,21,8,13,0,6,0,0
5519,797,19,6,13,0,5,0,1
232,530,16,4,12,0,3,0,0
3009,1766,14,5,9,3,6,0,1
6518,606,18,7,11,0,5,0,0
10669,470,15,3,12,0,3,0,0
5682,1099,26,6,20,0,5,0,0
1570,1039,24,7,17,0,4,0,0
1497,407,14,6,8,0,5,0,0
9723,1016,24,7,17,1,5,0,0
7261,318,12,5,7,0,8,0,1
2452,318,12,5,7,0,8,0,1
5621,316,12,6,6,0,9,0,1
10995,92,7,3,4,0,8,1,0
7373,302,11,4,7,0,6,0,1
5331,1869,16,3,13,0,2,0,0
263,145,7,3,4,0,8,0,1
4619,277,27,27,0,0,1,0,0
940,311,12,3,9,0,3,0,0
10084,50,5,2,3,0,7,0,0
6019,72,5,1,4,1,6,0,1
1463,21,3,1,2,0,7,0,0
6424,49,4,1,3,0,4,0,0
8233,556,17,7,10,1,5,0,0
1515,28,4,1,3,0,3,0,0
10855,396,13,4,9,0,5,0,0
10909,1899,20,5,15,2,1,0,0
3376,235,10,3,7,0,4,0,0
10232,331,12,3,9,0,3,0,0
5547,1919,19,7,12,2,3,0,1
8362,1919,19,7,12,2,3,0,1
3524,167,8,5,3,0,9,0,1
10095,1293,19,5,14,0,2,0,0
8897,654,17,7,10,0,8,0,1
466,746,20,4,16,0,2,0,0
11025,138,7,3,4,0,8,0,0
2387,275,11,5,6,0,8,0,1
1618,692,19,10,9,1,8,0,1
25,1115,19,6,13,0,4,0,0
3277,365,13,7,6,0,8,0,0
8566,9,3,1,2,0,7,0,0
2634,69,6,2,4,0,6,0,1
8036,63,7,2,5,0,4,0,0
8159,182,8,4,4,0,7,0,0
7628,76,6,2,4,0,5,0,0
9597,725,18,7,11,0,4,0,0
1384,62,5,2,3,1,8,0,0
10150,1449,18,7,11,1,2,0,1
3885,63,4,1,3,1,8,0,1
11003,50,5,2,3,0,7,0,0
8026,463,14,5,9,0,5,0,0
577,22,4,1,3,0,7,0,0
8702,22,4,1,3,0,7,0,0
5429,183,9,4,5,0,6,0,0
977,414,14,5,9,0,6,0,0
2793,1034,23,7,16,0,5,0,0
1071,1034,23,7,16,0,5,0,0
5074,47,4,1,3,0,7,0,0
2632,500,13,5,8,1,6,0,1
6404,282,11,4,7,0,5,0,0
10240,1381,20,10,10,2,4,0,1
2521,59,4,1,3,1,7,0,1
4301,59,4,1,3,1,7,0,1
7381,1442,21,11,10,3,4,0,1
2407,1555,19,6,13,1,4,0,1
9064,1555,19,6,13,1,4,0,1
5067,1378,20,2,18,4,5,0,0
10281,602,17,5,12,0,4,0,1
11191,139,7,2,5,0,6,0,0
2552,446,15,6,9,1,7,0,1
6720,492,14,7,7,1,7,0,1
4557,67,6,2,4,0,6,0,0
1183,22,3,1,2,0,6,0,0
4186,76,6,2,4,0,5,0,0
1419,76,6,2,4,0,5,0,0
967,515,16,5,11,0,7,0,1
1048,178,8,3,5,0,7,0,1
9262,52,4,1,3,1,7,0,0
3427,734,20,11,9,0,8,0,0
5892,221,10,3,7,0,7,0,0
8911,702,18,5,13,0,4,0,0
6606,1161,17,5,12,1,8,0,0
2677,241,10,3,7,0,4,0,0
252,601,16,6,10,0,6,0,0
9860,215,9,4,5,0,7,0,0
1388,112,6,2,4,0,6,0,0
979,112,6,2,4,0,6,0,0
7494,269,11,6,5,0,8,0,0
10490,417,12,6,6,0,7,0,0
3403,2092,19,2,17,0,6,0,0
2715,180,7,3,4,0,9,0,1
4828,792,20,5,15,0,1,0,0
92,89,7,3,4,0,6,0,0
3312,89,7,3,4,0,6,0,0
11176,495,16,5,11,0,3,0,0
1446,1226,27,6,21,0,1,0,0
9699,733,20,6,14,0,5,0,0
9790,1334,18,11,7,1,4,0,1
2324,1065,29,7,22,1,4,0,0
5080,1258,16,6,10,0,2,0,1
4992,69,6,3,3,0,7,0,1
7849,1052,24,2,22,0,1,0,0
4808,17,3,1,2,0,7,0,0
10401,18,3,0,3,0,3,1,0
7793,800,21,10,11,1,6,0,0
9303,32,1,1,0,0,13,0,0
6853,1438,20,3,17,2,1,0,1
7366,1438,20,3,17,2,1,0,1
9780,795,24,8,16,0,4,0,0
7573,86,5,2,3,1,7,0,1
1379,241,10,4,6,0,4,0,0
8923,1587,20,6,14,0,3,0,1
3547,64,5,2,3,0,6,0,1
8707,1401,15,5,10,0,3,0,1
1891,1754,15,4,11,0,2,0,1
6271,63,5,2,3,0,5,0,0
9635,129,7,3,4,0,6,0,0
9727,81,6,2,4,0,6,0,0
6205,80,6,2,4,0,5,0,1
10681,889,21,6,15,0,4,0,0
5156,889,21,6,15,0,4,0,0
3050,235,10,3,7,0,4,0,0
8164,1908,18,5,13,0,2,0,0
5626,463,15,4,11,0,4,0,0
7600,29,4,1,3,0,7,0,0
6406,1427,20,6,14,0,3,0,0
7002,398,13,3,10,0,3,0,0
8234,18,3,1,2,1,8,0,1
6116,75,5,1,4,0,3,0,0
291,981,12,3,9,0,1,0,0
8779,172,8,4,4,1,9,0,1
4931,1730,28,0,28,0,1,0,0
1650,1643,26,5,21,0,3,0,0
9701,312,9,4,5,0,7,0,0
6431,68,5,2,3,0,7,0,0
10789,68,5,2,3,0,7,0,0
5302,1428,15,4,11,0,2,0,1
4459,37,4,1,3,0,8,0,0
10642,37,4,1,3,0,8,0,0
9213,15,3,1,2,0,8,0,0
3678,656,18,8,10,1,7,0,1
3698,2130,18,4,14,1,2,0,1
5929,48,5,2,3,0,7,0,0
10795,48,5,2,3,0,7,0,0
4390,841,21,5,16,0,2,0,0
9362,568,17,9,8,1,6,0,0
1577,1736,14,4,10,1,1,0,1
4609,486,15,8,7,0,6,0,0
7143,820,21,4,17,0,2,0,0
1729,1377,18,3,15,0,6,0,0
10664,467,15,9,6,0,8,0,0
5029,14,3,0,3,0,5,0,0
10507,797,11,2,9,1,8,0,0
3865,73,6,3,3,0,8,0,1
6982,1581,23,4,19,0,2,0,0
7042,66,5,2,3,0,9,0,1
9668,77,6,2,4,0,8,0,0
6878,324,11,4,7,0,7,0,0
4099,62,4,1,3,0,8,0,0
5031,1833,25,5,20,1,2,0,1
1970,103,6,3,3,0,8,0,0
5726,60,7,3,4,0,5,1,0
5231,51,4,1,3,0,5,0,0
1307,63,7,3,4,0,4,0,0
10609,88,6,1,5,0,4,0,0
5782,763,20,9,11,1,5,0,0
7533,187,9,4,5,0,7,0,0
9493,1808,17,5,12,2,3,0,1
2253,85,5,1,4,0,6,0,0
2326,85,5,1,4,0,6,0,0
1876,85,5,1,4,0,6,0,0
7141,213,8,5,3,0,10,0,1
7393,92,6,2,4,0,5,0,0
4713,125,7,2,5,0,7,0,0
5093,101,6,3,3,0,9,0,1
8524,101,6,3,3,0,9,0,1
3766,835,18,9,9,0,9,0,1
9725,12,3,1,2,1,8,0,0
8933,66,6,2,4,0,6,0,0
10779,49,4,1,3,0,7,0,0
9289,63,5,2,3,0,8,0,1
2613,237,10,1,9,0,1,0,0
10133,2349,25,6,19,3,2,0,1
8443,86,6,3,3,1,8,0,1
10796,66,5,1,4,0,6,0,0
10241,14,3,1,2,0,6,0,0
3388,294,12,6,6,0,7,0,0
6507,56,6,1,5,0,3,0,0
7446,716,20,6,14,0,6,0,0
87,57,5,2,3,0,7,0,0
10477,102,6,3,3,0,7,0,0
6072,2087,19,5,14,1,3,0,1
2518,30,3,0,3,0,7,0,0
247,357,13,7,6,0,9,0,1
9463,1443,21,9,12,0,5,0,0
1459,928,13,5,8,0,3,0,0
9530,17,3,1,2,0,8,0,0
9653,68,5,2,3,0,8,0,0
10785,41,5,2,3,0,5,0,0
9392,17,3,1,2,0,7,0,0
10146,42,4,1,3,0,7,0,0
4741,562,17,6,11,1,5,0,0
1880,93,6,2,4,0,5,0,0
6471,59,6,2,4,0,5,0,0
5718,1415,22,5,17,2,3,0,1
3478,736,20,7,13,0,5,0,1
7848,368,11,5,6,0,6,0,0
7999,1743,16,5,11,2,2,0,1
11101,836,25,11,14,1,4,0,0
9212,1678,22,6,16,0,7,0,0
10983,930,22,6,16,0,3,0,0
3629,145,7,3,4,0,7,0,0
4673,1241,18,10,8,1,5,0,1
796,1071,23,11,12,0,8,0,0
618,797,21,7,14,0,4,0,0
380,1804,24,11,13,1,8,0,1
1092,1147,16,9,7,0,7,0,0
8962,37,5,2,3,0,5,0,0
8207,40,4,1,3,0,4,0,0
6521,1101,19,4,15,0,1,0,0
535,778,26,3,23,0,1,0,0
4608,778,26,3,23,0,1,0,1
11086,21,4,1,3,0,7,0,0
1064,42,4,1,3,0,8,0,0
7000,817,22,2,20,0,1,0,0
1581,17,3,1,2,0,8,0,1
7384,485,15,7,8,0,8,0,0
10552,367,12,4,8,0,5,0,0
6409,1179,19,7,12,0,6,0,1
9507,434,14,6,8,0,7,0,0
9560,1674,21,7,14,1,3,0,1
10991,850,13,5,8,0,2,0,0
4712,82,6,1,5,0,4,0,0
11056,1188,17,3,14,0,1,0,0
7414,186,8,3,5,0,8,0,0
3076,612,18,4,14,0,3,0,0
6355,45,6,2,4,0,3,0,0
7959,1370,10,3,7,0,1,0,0
5512,518,16,7,9,0,5,0,0
10102,1478,21,5,16,0,3,0,0
9369,1274,31,11,20,2,5,0,1
3711,1902,19,6,13,2,3,0,0
6931,1062,15,8,7,1,4,0,1
9596,664,19,3,16,0,2,0,0
2727,409,12,3,9,0,3,0,0
8416,44,5,2,3,0,6,0,0
3967,943,23,2,21,0,1,0,0
2139,31,5,2,3,0,5,0,0
2162,561,16,3,13,0,3,0,0
9242,1722,18,6,12,1,4,0,1
10595,69,5,2,3,0,7,0,0
4855,46,5,3,2,0,9,0,1
5049,46,5,3,2,0,9,0,0
4967,268,11,5,6,0,8,0,0
9215,551,16,6,10,0,7,0,0
3525,17,3,1,2,0,7,0,0
3619,1152,16,5,11,1,2,0,1
4415,38,5,1,4,0,7,0,0
3645,70,6,2,4,0,8,0,1
4692,71,7,4,3,1,9,0,1
3955,6,0,0,0,0,14,0,0
5313,44,6,2,4,0,5,0,0
7196,13,3,0,3,0,3,0,0
1381,324,12,6,6,0,8,0,1
10951,306,12,3,9,1,4,0,0
4322,1291,19,4,15,0,2,0,0
7444,30,4,1,3,0,8,0,0
2942,486,13,5,8,1,5,0,0
2874,32,4,1,3,0,7,0,0
3667,1757,24,8,16,3,8,0,1
3697,134,7,3,4,0,7,0,0
9955,134,7,3,4,0,7,0,0
5320,171,8,3,5,0,6,0,1
6422,1270,16,5,11,0,2,0,0
3690,2091,21,7,14,1,6,0,1
2408,733,20,7,13,0,7,0,0
9260,1706,25,10,15,0,6,0,0
9648,253,10,5,5,0,8,0,0
4939,317,11,4,7,0,7,0,0
8652,317,11,4,7,0,7,0,0
4702,1895,16,4,12,0,8,0,0
2587,20,5,2,3,0,5,0,0
2811,62,5,1,4,0,4,0,0
9150,62,5,1,4,0,4,0,0
10127,395,14,8,6,0,7,0,0
5493,23,3,1,2,1,6,0,0
2666,907,22,8,14,1,3,0,0
10099,882,21,5,16,0,4,0,0
10562,1033,23,6,17,0,2,0,0
7881,1033,23,6,17,0,2,0,0
6721,1213,14,6,8,0,3,0,0
5204,1461,21,8,13,1,3,0,1
5209,638,17,8,9,0,7,0,0
10128,907,22,5,17,0,5,0,0
9284,907,22,5,17,0,5,0,0
8643,1662,21,4,17,0,3,0,0
1685,1482,22,4,18,1,3,0,0
2877,541,16,7,9,0,7,0,0
8369,28,3,0,3,0,8,0,0
6233,971,24,9,15,0,7,0,0
195,246,10,5,5,1,8,0,1
1501,1717,29,0,29,0,0,0,0
10846,629,16,7,9,1,7,0,0
8341,34,4,1,3,1,7,0,1
10766,506,16,4,12,0,2,0,0
9971,506,16,4,12,0,2,0,0
1740,999,14,7,7,1,4,0,0
8737,43,5,2,3,0,3,0,0
6466,121,7,2,5,0,3,0,0
10430,1472,11,4,7,3,5,0,0
8773,322,12,5,7,1,7,0,0
2371,81,6,2,4,0,7,0,0
7786,160,8,3,5,0,8,0,0
4088,155,8,3,5,0,8,0,0
4971,155,8,3,5,0,8,0,0
10560,20,4,1,3,0,5,0,0
6892,732,20,10,10,2,8,0,0
11004,22,3,1,2,0,4,0,0
1818,38,4,2,2,0,9,0,0
9485,199,9,2,7,0,4,0,0
6646,22,4,1,3,0,6,0,0
4248,2008,19,4,15,1,1,0,0
7451,2008,19,4,15,1,1,0,0
7861,1175,17,8,9,0,4,0,0
5232,227,10,4,6,0,4,0,0
3011,227,10,4,6,0,4,0,0
5758,1189,27,10,17,4,6,0,1
2173,32,4,1,3,0,6,0,0
10711,894,21,3,18,0,1,0,0
2782,404,14,6,8,0,6,0,0
9432,62,7,3,4,0,6,0,0
5872,639,18,4,14,0,3,0,0
11187,69,6,2,4,0,5,0,0
2428,78,6,2,4,0,7,0,0
1726,81,4,1,3,1,9,0,1
1802,680,18,3,15,0,2,0,0
1162,653,18,5,13,0,5,0,1
10643,653,18,5,13,0,5,0,1
11112,1477,19,5,14,0,3,0,0
2114,1315,25,7,18,2,3,0,1
4261,1315,25,7,18,2,3,0,1
2457,45,4,1,3,0,7,0,0
2495,816,21,4,17,0,1,0,0
6983,45,5,2,3,0,7,0,0
3436,20,4,1,3,0,7,0,0
7505,46,4,1,3,0,4,0,0
4286,679,19,7,12,1,4,0,0
7224,31,4,1,3,0,8,0,0
6215,31,4,1,3,0,8,0,1
968,187,9,4,5,0,7,0,0
4096,187,9,4,5,0,7,0,0
3153,17,3,1,2,0,8,0,0
6504,78,6,2,4,1,5,0,0
5329,11,3,0,3,0,5,0,0
1175,426,11,3,8,1,6,0,1
1377,285,10,4,6,0,7,0,0
4607,777,16,4,12,0,2,0,0
4944,777,16,4,12,0,2,0,0
9483,637,18,4,14,0,3,1,0
1378,694,17,7,10,0,6,0,0
5991,266,10,5,5,0,7,0,0
2807,1001,24,8,16,0,7,0,0
1052,1001,24,8,16,0,7,0,0
9760,1198,25,10,15,0,8,0,1
7101,1198,25,10,15,0,8,0,0
9909,122,7,3,4,0,9,0,1
5907,18,3,1,2,0,8,0,0
793,45,5,2,3,0,9,0,0
8832,123,7,3,4,0,7,0,0
2535,844,19,6,13,3,9,0,1
1523,96,6,2,4,0,5,0,0
1839,141,7,3,4,0,7,0,0
9972,46,4,1,3,2,7,0,0
2945,46,4,1,3,2,7,0,0
9291,15,3,0,3,0,5,0,0
2829,731,20,9,11,2,6,0,0
8594,135,7,3,4,0,6,0,0
1592,1724,15,4,11,2,1,0,0
4310,1428,20,5,15,1,1,0,1
6950,54,5,2,3,0,7,0,0
8492,1493,22,8,14,1,6,0,0
5684,68,5,2,3,0,7,0,0
5909,1171,15,3,12,0,8,0,0
9855,1020,25,6,19,1,4,0,0
975,264,10,4,6,0,6,0,0
8754,20,3,1,2,0,7,0,0
1456,1180,24,10,14,0,7,0,0
2849,1180,24,10,14,0,7,0,0
9984,724,17,8,9,2,8,0,1
5527,58,5,2,3,0,8,0,0
5628,1665,23,10,13,1,6,0,0
7627,2086,21,5,16,2,2,0,1
1351,1220,28,7,21,1,6,0,0
10395,101,7,3,4,0,8,0,0
6961,11,3,1,2,0,8,0,0
10196,614,18,8,10,0,4,0,0
6182,53,6,2,4,0,6,0,0
10432,22,4,1,3,0,8,0,0
1542,396,14,4,10,0,5,0,0
4220,87,6,2,4,0,3,0,0
4141,776,20,8,12,0,4,0,0
1940,18,3,1,2,0,8,0,0
1506,140,7,2,5,0,6,0,1
6347,36,4,1,3,0,8,0,0
1361,1435,15,3,12,2,1,0,1
9422,131,7,2,5,0,3,0,0
1081,1019,14,6,8,0,4,0,0
7458,97,6,3,3,0,8,0,0
1012,884,20,8,12,0,7,0,0
5453,2352,23,4,19,1,2,0,0
6818,369,11,5,6,0,6,0,0
7807,369,11,5,6,0,6,0,0
7532,132,7,3,4,0,8,0,0
8346,296,10,6,4,1,9,0,1
5564,1338,18,7,11,0,4,0,0
3267,608,17,8,9,1,6,0,0
3091,823,20,7,13,0,4,0,0
762,823,20,7,13,0,4,0,0
8029,1621,14,3,11,3,1,0,1
4376,93,6,2,4,1,7,0,1
10981,1198,17,3,14,0,1,0,0
486,1198,17,3,14,0,1,0,0
1158,144,7,3,4,0,7,0,0
9119,392,13,3,10,0,2,0,0
6694,1068,24,8,16,0,4,0,0
10573,421,17,6,11,1,3,0,0
10140,1727,16,5,11,2,3,0,0
2286,114,6,2,4,0,6,0,0
8420,64,6,2,4,0,5,0,0
10065,64,6,2,4,0,5,0,0
1029,279,11,5,6,0,5,0,0
4207,1298,24,6,18,2,2,0,0
10277,42,4,1,3,0,7,0,0
4436,137,7,2,5,0,7,0,0
2929,137,7,2,5,0,7,0,0
6281,982,14,6,8,1,4,0,0
10390,30,4,1,3,0,6,0,0
2574,1230,18,6,12,3,5,0,1
709,1103,15,2,13,0,8,0,0
5955,1932,15,4,11,0,3,0,0
8486,367,13,9,4,0,10,0,0
10343,1345,17,3,14,0,3,0,0
6652,1134,16,3,13,0,1,0,0
8746,1188,17,2,15,2,6,0,0
4686,1686,24,6,18,1,2,0,0
3551,198,8,2,6,0,2,0,0
4338,44,4,1,3,1,4,0,0
4444,61,5,2,3,0,8,0,0
498,57,5,1,4,0,5,0,0
8230,71,5,2,3,0,7,0,0
2826,37,5,2,3,0,7,0,0
6222,37,5,2,3,0,7,0,0
7352,405,13,3,10,0,3,0,0
10928,599,15,7,8,0,5,0,0
10736,1525,20,6,14,0,2,0,0
10163,1323,19,8,11,0,4,0,1
6168,53,4,1,3,0,4,0,0
4656,710,19,10,9,1,9,0,0
626,43,4,1,3,0,4,0,0
3870,1006,23,7,16,0,4,0,0
6299,813,18,6,12,1,7,0,1
7798,429,13,7,6,0,7,0,0
9973,490,16,7,9,0,7,0,0
4299,1825,27,11,16,0,7,0,1
10971,473,12,7,5,1,9,1,1
9931,9,0,0,0,0,19,0,0
6679,16,3,0,3,0,3,0,0
5961,57,4,1,3,0,5,0,0
6255,334,12,4,8,0,2,0,0
8614,507,16,4,12,0,2,0,0
7828,818,11,3,8,0,1,0,0
1277,1004,27,10,17,1,4,0,0
3595,1138,26,6,20,0,3,0,0
5735,2525,17,3,14,1,1,0,0
5350,2525,17,3,14,1,1,0,1
4137,1076,15,7,8,0,4,0,0
6357,491,15,7,8,0,5,0,0
9316,29,4,1,3,0,6,0,0
3578,236,10,3,7,0,6,0,0
153,46,4,1,3,0,4,0,0
10524,795,18,2,16,0,2,0,0
1518,749,19,9,10,0,7,0,0
2036,401,14,4,10,0,4,0,0
9495,1149,16,2,14,0,1,0,0
2631,1149,16,2,14,0,1,0,0
6312,863,26,10,16,0,7,0,0
615,343,10,5,5,0,7,0,0
4406,1471,21,9,12,0,5,0,0
10061,1088,23,9,14,0,7,0,0
10619,1990,17,7,10,1,3,0,1
4945,1210,26,10,16,0,6,0,0
1777,74,5,2,3,0,8,0,0
4023,115,7,3,4,0,8,0,1
7922,966,23,11,12,1,7,0,0
10699,92,6,3,3,0,8,0,0
7516,45,5,2,3,0,6,0,0
3129,45,5,2,3,0,6,0,0
5121,761,18,7,11,1,5,0,0
2186,2257,21,5,16,3,2,0,1
10548,960,23,3,20,0,1,0,0
6384,1453,18,5,13,1,8,0,0
2625,350,12,3,9,0,3,0,0
1676,266,11,4,7,0,5,0,0
5534,224,8,3,5,1,7,0,0
6859,99,7,4,3,0,9,0,0
271,258,10,3,7,1,6,0,0
7699,258,10,3,7,1,6,0,0
7832,1526,22,8,14,3,4,0,1
938,87,5,2,3,1,8,0,0
7873,300,12,4,8,0,5,0,0
9967,447,14,6,8,0,8,0,0
1087,173,7,4,3,0,9,0,1
8314,1772,18,5,13,1,2,0,0
3762,925,16,3,13,1,1,0,1
10383,1093,20,5,15,0,3,0,1
6798,433,14,5,9,0,7,0,1
4168,433,14,5,9,0,7,0,1
6690,90,7,3,4,0,7,0,0
10602,156,7,3,4,0,8,0,0
3220,156,7,3,4,0,8,0,0
5424,156,7,3,4,0,8,0,0
7488,825,21,5,16,0,3,0,0
5289,72,4,1,3,0,4,0,0
347,377,13,7,6,0,9,0,0
5236,2194,20,10,10,3,5,0,0
9478,401,13,4,9,0,3,0,0
477,2157,21,4,17,4,1,0,1
7411,17,4,1,3,0,6,0,0
3107,350,12,4,8,0,2,0,0
7437,29,5,1,4,0,3,0,0
255,21,4,1,3,0,6,1,0
3790,15,3,1,2,0,6,0,0
749,145,7,3,4,1,6,0,1
1503,107,1,0,1,0,1,0,0
8650,42,4,1,3,0,4,0,0
607,521,16,8,8,0,8,0,0
1008,1021,23,7,16,1,6,0,0
9396,25,3,1,2,0,9,0,0
933,25,3,1,2,0,9,0,0
5710,120,7,2,5,1,5,0,0
2882,995,14,3,11,0,8,0,0
2379,1635,12,3,9,0,7,0,1
5342,29,4,1,3,0,8,0,0
3262,1655,24,2,22,0,5,0,1
5832,1263,21,3,18,0,0,0,0
5025,135,7,2,5,0,3,0,0
569,1991,18,5,13,3,2,0,1
3102,32,4,1,3,0,8,0,0
9449,605,18,5,13,0,3,0,0
8104,278,11,5,6,0,7,0,0
75,467,14,8,6,0,8,0,0
6421,2116,20,4,16,1,1,0,0
3037,410,14,5,9,0,5,0,0
4698,410,14,5,9,0,5,0,0
948,41,5,1,4,0,5,0,0
6177,169,8,4,4,0,8,0,0
3517,161,7,3,4,0,9,0,1
3491,1260,25,11,14,0,7,0,0
7610,460,14,6,8,0,8,0,0
4377,575,13,7,6,1,7,0,0
9850,19,3,0,3,0,7,0,0
5544,1490,20,7,13,1,5,0,0
6497,433,13,6,7,0,8,0,0
4543,1919,18,2,16,1,4,0,0
5117,576,16,4,12,0,5,0,0
1448,51,6,2,4,0,4,0,0
6887,564,17,8,9,0,6,0,0
7500,564,17,8,9,0,6,0,0
2724,19,3,0,3,0,3,0,0
2256,21,4,1,3,0,6,0,0
1100,61,7,3,4,0,5,0,0
7725,641,15,4,11,0,1,0,0
2612,1682,24,7,17,1,3,0,0
113,28,4,1,3,0,5,0,0
2868,57,5,2,3,0,8,0,1
4216,1474,25,7,18,2,3,0,1
199,315,12,4,8,1,7,0,0
359,504,16,8,8,0,7,1,0
8842,44,5,2,3,0,7,0,0
2154,44,5,2,3,0,7,0,0
6050,1513,22,6,16,1,9,0,0
9204,1029,13,4,9,0,3,0,0
4472,57,5,1,4,0,2,0,0
6864,30,6,3,3,0,5,0,0
10617,30,6,3,3,0,5,0,0
3924,916,23,8,15,1,5,0,0
5654,61,5,2,3,0,6,0,0
9216,44,5,2,3,0,6,0,0
8086,55,5,2,3,0,7,0,0
9097,343,12,3,9,0,4,0,0
7631,989,22,5,17,0,3,0,0
7275,131,7,2,5,0,6,0,0
8334,131,7,2,5,0,6,0,0
1987,59,5,2,3,0,6,0,0
2281,28,3,1,2,1,7,0,0
7034,55,5,2,3,0,8,0,0
2797,1073,25,9,16,0,5,0,0
3934,608,16,7,9,0,5,0,0
2493,608,16,7,9,0,5,0,0
3759,1155,24,7,17,1,5,0,0
965,590,17,7,10,0,6,0,0
7378,573,17,10,7,1,9,0,0
1859,1890,18,7,11,0,5,0,1
6263,106,6,2,4,0,8,0,0
2072,1064,15,4,11,1,9,0,1
8908,1097,19,3,16,0,1,0,1
738,182,8,3,5,0,7,0,0
10129,1456,20,3,17,1,1,0,0
807,292,11,6,5,0,8,0,0
3334,2211,21,5,16,2,1,0,0
5423,16,3,1,2,0,7,0,0
4426,527,15,7,8,1,7,0,0
10489,1778,22,6,16,2,2,0,1
2570,815,21,10,11,2,8,0,1
3834,861,21,8,13,0,5,0,0
590,1812,15,5,10,0,3,0,1
4791,41,4,1,3,0,8,0,0
5304,33,4,1,3,0,6,0,0
2426,895,28,5,23,0,3,0,1
35,210,7,2,5,0,6,0,1
8041,1092,15,3,12,0,9,0,0
3584,1396,20,5,15,1,8,0,1
7718,711,9,1,8,0,1,0,0
8605,68,5,2,3,0,6,0,0
1646,46,5,1,4,0,3,0,0
9206,1121,24,5,19,1,1,0,0
10757,13,3,1,2,0,6,0,0
6885,55,5,2,3,0,7,0,0
907,362,13,5,8,0,5,0,0
1150,1853,14,4,10,1,1,0,0
3867,1095,25,9,16,0,4,0,0
3859,1095,25,9,16,0,4,0,0
3265,46,4,1,3,0,6,0,0
4418,1644,24,7,17,0,2,0,1
4611,1724,30,9,21,2,3,0,1
4530,1930,20,3,17,1,3,0,1
7736,61,5,2,3,1,5,0,1
9949,877,12,3,9,0,8,0,0
942,299,11,7,4,0,9,0,1
6181,939,26,8,18,0,6,0,0
7660,49,4,1,3,1,5,0,1
2055,49,4,1,3,1,5,0,0
5107,49,4,1,3,1,5,0,0
1626,49,4,1,3,1,5,0,1
6428,1130,16,1,15,0,0,0,0
9617,19,4,1,3,0,3,0,0
4339,913,23,5,18,0,2,0,0
7235,38,6,2,4,0,5,0,0
8527,395,14,6,8,0,7,0,0
1968,28,3,1,2,0,7,0,0
9862,33,5,2,3,0,6,0,0
11075,270,11,3,8,0,4,0,0
6658,1194,25,11,14,0,6,0,0
4552,393,11,3,8,0,4,0,0
10377,397,12,6,6,0,6,0,0
5336,59,2,1,1,0,1,0,0
10350,38,4,1,3,0,4,0,0
11071,1923,15,3,12,0,1,0,1
11100,63,5,2,3,0,7,0,0
6516,18,3,1,2,0,7,0,0
1734,81,7,3,4,0,7,0,0
2131,1307,19,9,10,0,6,0,0
6439,1102,24,11,13,0,7,0,0
10591,201,9,4,5,0,7,0,0
9797,443,14,3,11,0,2,0,0
9336,636,18,6,12,0,4,0,0
2174,27,4,1,3,0,5,0,0
3197,670,18,6,12,0,4,0,0
9185,1029,15,4,11,0,3,0,1
905,84,7,4,3,0,8,0,0
10858,820,21,9,12,0,5,0,0
8925,1012,23,8,15,0,5,0,0
2499,563,17,5,12,0,4,0,0
1109,12,3,1,2,0,7,0,0
326,315,12,5,7,0,6,0,0
10967,99,6,2,4,0,7,0,0
5370,413,14,7,7,1,8,0,0
2098,17,3,1,2,0,8,0,0
1773,57,5,2,3,0,9,0,0
5036,406,12,4,8,0,6,0,0
4856,1853,24,7,17,2,3,0,0
8722,1853,24,7,17,2,3,0,1
2156,41,6,2,4,0,5,0,0
2569,46,4,1,3,0,8,0,0
10151,946,21,4,17,0,3,0,0
10473,528,19,6,13,2,7,0,1
7079,1245,27,9,18,0,6,0,0
6875,529,15,7,8,0,8,0,0
6728,48,4,1,3,0,9,0,0
2471,299,11,3,8,0,2,0,0
49,25,4,1,3,0,7,0,0
4973,25,4,1,3,0,7,0,0
6387,77,6,2,4,1,5,0,0
5866,219,9,4,5,0,7,0,0
8523,60,7,4,3,0,8,0,0
7901,22,3,0,3,0,4,0,0
898,147,7,3,4,0,8,0,0
10242,75,6,2,4,0,5,0,0
5835,65,6,2,4,0,8,0,0
6919,63,6,2,4,0,6,0,0
6197,57,6,3,3,0,9,0,0
4201,468,14,4,10,0,5,0,0
5092,467,15,7,8,1,8,0,1
6566,1319,19,5,14,0,8,0,0
6613,727,20,8,12,0,8,0,0
9094,587,14,7,7,0,6,0,1
9847,587,14,7,7,0,6,0,0
10767,1346,20,3,17,2,1,0,0
7943,35,5,1,4,0,2,0,0
1055,45,4,1,3,0,4,0,0
1458,44,6,3,3,0,6,0,0
8402,794,20,7,13,0,4,0,0
6246,1507,22,3,19,0,1,0,1
4654,1253,18,3,15,0,2,0,0
6103,100,6,2,4,0,4,0,0
8147,48,5,2,3,0,8,0,0
10207,15,3,1,2,0,8,0,0
4838,15,3,1,2,0,8,0,0
10219,38,4,1,3,0,8,0,0
2176,1690,14,5,9,3,6,0,1
9121,1690,14,5,9,3,6,0,1
5802,75,6,2,4,0,6,0,0
10790,21,3,1,2,0,8,0,0
178,973,22,8,14,0,5,0,0
2308,330,12,6,6,0,7,0,0
7431,1820,16,7,9,1,9,0,1
9405,172,8,3,5,0,7,0,1
10525,27,3,1,2,1,9,0,1
7503,2209,22,5,17,1,4,0,1
8783,454,15,4,11,0,3,0,0
1403,38,4,1,3,0,7,0,0
4643,176,7,3,4,0,8,0,0
3463,904,23,7,16,0,5,0,0
4055,64,6,3,3,0,6,0,0
7010,1363,19,6,13,1,3,0,0
4767,1363,19,6,13,1,3,0,0
1927,690,13,4,9,0,2,0,0
437,1027,22,3,19,0,1,0,0
4331,1371,20,3,17,2,1,0,0
4084,873,21,6,15,0,4,0,0
8135,52,4,1,3,0,7,0,0
9750,1307,18,10,8,0,7,0,0
6682,37,4,1,3,0,8,0,0
10581,506,14,7,7,0,8,0,0
3710,81,5,2,3,0,7,1,1
5207,793,19,9,10,0,8,0,1
9360,316,11,4,7,0,8,0,0
4679,1092,25,7,18,0,4,0,0
1340,1795,26,6,20,3,1,0,0
10839,29,4,1,3,0,4,0,0
5303,1113,19,6,13,0,2,0,0
9829,78,6,2,4,0,6,0,0
10469,1623,17,6,11,0,2,0,0
3602,195,9,3,6,0,4,0,0
4756,1168,24,7,17,0,4,0,1
8181,177,8,4,4,0,8,0,0
6958,26,4,1,3,0,6,0,0
10856,46,4,1,3,0,6,0,0
3321,542,17,7,10,0,5,0,0
5394,38,6,1,5,0,3,0,0
433,632,18,11,7,0,8,0,0
6320,1508,22,6,16,0,3,0,0
5376,1730,28,0,28,0,1,0,0
1867,1336,18,9,9,0,5,0,1
4324,684,16,8,8,0,8,0,0
3661,1435,18,4,14,0,2,0,0
521,581,16,8,8,0,7,0,0
10403,44,6,3,3,0,7,0,0
7186,35,4,1,3,1,5,0,0
4329,16,4,1,3,0,7,0,0
4394,1501,22,5,17,2,2,0,0
1717,273,10,5,5,0,8,0,0
1016,55,5,2,3,0,6,0,0
3783,116,7,2,5,0,5,0,0
5848,2009,18,5,13,3,2,0,1
10727,1586,23,7,16,0,8,0,0
5299,1586,23,7,16,0,8,0,0
6872,405,14,4,10,0,4,0,0
1143,55,5,2,3,0,7,0,0
10381,21,3,1,2,0,6,0,0
11007,34,4,1,3,0,8,0,0
9145,1478,20,5,15,0,2,0,0
5267,44,4,1,3,0,7,0,0
9738,100,6,3,3,0,8,0,0
10212,100,6,3,3,0,8,0,0
10010,152,7,3,4,0,9,0,1
10069,58,4,2,2,1,9,0,0
2694,24,4,1,3,0,6,0,0
10613,62,7,3,4,0,4,0,0
4646,978,24,5,19,1,2,0,0
6935,978,24,5,19,1,2,0,0
5596,728,20,9,11,0,6,0,0
1044,596,17,5,12,0,4,0,0
9274,1213,22,6,16,1,2,0,0
9076,185,9,4,5,0,8,0,0
4947,2059,23,7,16,2,4,0,1
10176,416,16,4,12,2,8,0,1
3507,1575,12,2,10,0,6,0,1
10341,222,9,2,7,0,2,0,0
2639,68,6,3,3,0,6,0,0
6201,49,5,2,3,0,7,1,0
7397,688,18,7,11,0,7,0,0
2181,1280,13,3,10,0,2,0,0
1204,1829,27,11,16,1,8,0,0
1170,244,10,5,5,0,8,0,0
8812,48,5,2,3,0,7,0,0
4690,586,17,8,9,0,8,0,0
1715,48,5,2,3,0,7,0,0
10821,263,10,4,6,0,7,0,0
6543,1612,13,3,10,0,2,0,0
7119,825,11,2,9,0,1,0,0
3518,50,4,1,3,0,9,0,0
1245,1371,19,4,15,1,8,0,0
2561,1371,19,4,15,1,8,0,0
9624,963,13,3,10,0,1,0,0
10509,71,6,3,3,0,8,0,0
7629,31,5,2,3,0,7,0,0
7875,1677,25,4,21,3,2,0,1
2815,120,7,4,3,0,7,0,0
2936,23,4,1,3,0,7,0,0
3665,54,6,3,3,0,8,0,0
10888,636,18,8,10,0,6,0,0
6637,1117,14,3,11,0,1,0,0
5077,969,23,6,17,0,3,0,0
6173,969,23,6,17,0,3,0,0
3969,133,6,2,4,0,5,0,0
4580,2486,25,9,16,3,5,0,1
663,71,5,1,4,0,4,0,0
8299,71,5,1,4,0,4,0,0
8945,203,9,4,5,0,6,0,0
10870,1341,16,9,7,0,5,0,0
1184,845,22,10,12,0,5,0,0
6141,385,12,6,6,0,7,0,0
8825,564,16,9,7,0,8,0,0
2217,23,3,0,3,0,6,0,0
4102,23,3,0,3,0,6,0,0
4653,189,8,3,5,0,8,0,0
10092,1504,22,7,15,0,5,0,0
5788,209,9,3,6,0,5,0,0
4669,102,7,3,4,0,7,0,0
6295,981,22,11,11,0,8,0,0
7453,488,15,3,12,1,4,0,1
10841,484,15,4,11,0,4,0,0
821,2077,21,5,16,0,2,0,0
3933,662,18,10,8,0,9,0,0
1225,1495,18,3,15,1,1,0,0
7059,1495,18,3,15,1,1,0,0
5633,231,10,3,7,0,5,0,0
843,805,21,8,13,0,6,0,0
6211,39,4,1,3,0,6,0,0
7007,63,6,3,3,0,7,0,0
9671,69,6,3,3,1,8,0,1
8975,69,6,3,3,1,8,0,0
6616,461,14,3,11,0,2,0,0
6248,2217,27,9,18,1,3,0,1
7428,1367,18,3,15,0,1,0,0
3075,382,14,3,11,0,1,0,0
2937,871,22,8,14,0,6,0,0
203,2089,21,5,16,0,2,0,0
2021,1388,29,6,23,0,4,0,0
880,96,5,2,3,0,8,0,0
524,96,5,2,3,0,8,0,0
10837,68,5,2,3,0,6,0,1
7011,93,7,3,4,0,7,0,0
4184,265,10,3,7,0,4,0,0
7679,28,5,1,4,0,3,0,0
7485,138,7,2,5,0,4,0,0
7530,138,7,2,5,0,4,0,0
4369,1169,14,3,11,0,2,0,0
10652,1169,14,3,11,0,2,0,0
286,152,8,2,6,0,6,0,0
5922,218,10,4,6,0,7,0,0
7250,612,18,7,11,0,6,0,0
2478,38,5,1,4,0,4,0,0
1160,49,6,3,3,0,8,0,0
9214,358,12,5,7,0,5,0,0
273,151,8,3,5,1,7,0,0
851,642,17,5,12,0,6,0,0
9729,615,17,8,9,0,7,0,0
9665,361,12,5,7,0,6,0,0
2620,23,3,1,2,0,8,0,1
8254,23,3,1,2,0,8,0,0
3852,964,23,9,14,0,5,0,0
1000,964,23,9,14,0,5,0,0
3099,310,11,5,6,0,9,0,0
6318,1366,29,9,20,0,4,0,0
5396,1366,29,9,20,0,4,0,0
7966,1191,27,11,16,0,5,1,0
454,1135,26,11,15,0,6,0,0
309,1101,16,8,8,1,6,0,0
3571,1101,16,8,8,1,6,0,1
8395,1511,21,3,18,0,6,0,1
2591,932,13,6,7,0,2,0,0
1640,108,6,1,5,0,3,0,0
810,641,17,4,13,0,2,0,0
9423,46,6,2,4,0,5,0,0
89,69,6,2,4,0,6,0,0
5294,57,7,3,4,0,7,0,0
1321,56,6,3,3,0,8,0,0
2686,26,3,1,2,0,7,0,0
1215,1572,22,5,17,1,3,0,0
9283,18,3,0,3,0,4,0,0
3120,22,3,1,2,0,8,1,0
5868,46,4,1,3,0,7,0,0
8143,265,11,4,7,2,7,0,1
3479,50,5,2,3,1,7,0,0
7214,1283,17,4,13,0,3,0,0
5543,802,20,7,13,1,5,0,0
9347,46,4,1,3,0,5,0,0
10160,46,4,1,3,0,5,0,0
1406,415,14,6,8,0,7,0,0
7019,211,9,3,6,0,4,0,0
2157,77,6,2,4,0,6,0,0
8939,730,19,5,14,0,5,0,0
10250,28,3,1,2,0,7,0,0
1272,903,22,7,15,0,5,0,0
3007,40,4,1,3,0,8,0,0
5513,40,4,1,3,0,8,0,0
679,38,4,1,3,0,9,0,0
8876,152,8,3,5,0,9,0,0
10827,146,7,3,4,0,9,0,0
7300,535,16,8,8,1,5,0,0
4268,158,8,3,5,0,4,0,0
4603,656,19,5,14,0,4,0,0
8659,1038,25,6,19,0,2,0,0
10708,33,4,1,3,0,7,0,0
1176,25,3,1,2,0,8,0,0
10380,106,6,3,3,0,8,0,0
7037,401,14,4,10,0,6,0,0
11096,232,10,2,8,0,2,0,0
6374,297,11,5,6,0,8,0,0
5552,293,11,4,7,0,6,0,0
2245,139,7,2,5,0,6,0,0
6200,901,21,6,15,0,3,0,0
9904,1043,23,6,17,0,3,0,0
10031,53,7,3,4,0,8,0,0
6642,102,7,2,5,0,6,0,0
10882,915,13,4,9,0,4,0,0
5636,167,7,4,3,0,8,0,1
8692,240,10,4,6,0,8,0,0
8091,1106,16,6,10,0,5,0,0
8080,22,3,0,3,0,4,0,0
8370,1159,16,7,9,0,4,0,0
4550,71,5,1,4,0,5,0,0
3381,90,6,2,4,0,6,0,0
10556,358,13,6,7,1,7,0,0
9467,20,4,1,3,0,6,0,0
2891,928,21,8,13,0,6,0,0
5011,928,21,8,13,0,6,0,0
8140,95,7,2,5,0,4,0,0
11039,311,11,5,6,0,5,0,0
78,37,4,1,3,0,8,0,0
5517,37,4,1,3,0,8,0,0
5290,279,11,5,6,0,8,0,0
4128,725,18,7,11,0,5,0,0
8534,992,24,6,18,1,4,0,0
9592,33,5,2,3,0,8,0,0
8957,1120,14,6,8,0,6,0,0
9308,976,13,3,10,0,1,0,0
544,976,13,3,10,0,1,0,0
5989,1576,23,10,13,0,8,0,0
635,610,17,9,8,0,8,0,0
6673,129,6,3,3,0,8,0,0
1710,279,11,6,5,0,9,0,0
523,74,6,2,4,0,5,0,0
8977,24,3,0,3,0,4,0,0
9736,96,6,3,3,0,8,0,0
1544,1893,16,4,12,0,2,0,0
6575,612,17,9,8,0,9,0,0
6147,28,3,0,3,0,7,0,0
6354,47,4,1,3,0,8,0,1
4769,493,16,8,8,1,7,0,0
7540,270,11,2,9,0,2,0,0
5247,45,5,1,4,0,4,0,0
5987,43,5,1,4,0,5,0,0
9960,14,3,1,2,0,7,0,0
10972,939,13,4,9,2,1,0,0
1399,1515,19,3,16,1,1,0,0
2698,415,14,6,8,0,6,0,0
6340,26,4,1,3,0,6,0,0
4107,425,14,4,10,0,5,0,0
10906,425,14,4,10,0,5,0,0
2557,29,4,1,3,1,4,0,0
8786,450,14,6,8,0,6,0,0
6119,17,3,1,2,0,6,0,0
2980,35,6,3,3,0,8,0,0
3850,43,4,1,3,0,6,0,0
1077,1020,14,7,7,0,4,0,0
9733,80,4,1,3,1,6,0,0
8462,80,4,1,3,1,6,0,0
4764,169,8,3,5,0,7,0,1
2223,1826,25,8,17,0,6,0,0
7788,10,3,0,3,0,3,0,0
5827,62,7,3,4,0,5,0,0
2958,57,7,2,5,0,4,0,0
4954,265,11,4,7,0,6,0,0
3139,2052,18,4,14,1,2,0,0
9952,1105,16,4,12,0,1,0,0
8180,310,12,6,6,0,6,0,0
3276,78,6,3,3,0,7,0,0
4994,1735,25,7,18,1,3,0,0
3598,606,18,4,14,0,4,0,0
945,133,7,3,4,0,7,0,0
5048,131,6,3,3,0,8,0,0
6214,79,5,2,3,0,6,0,0
6230,189,9,5,4,0,8,0,0
2968,902,22,7,15,1,6,0,1
8800,902,22,7,15,1,6,0,1
1907,1477,21,8,13,0,7,0,1
10478,633,18,11,7,0,9,0,1
4188,354,11,5,6,0,8,0,1
2225,1617,20,4,16,2,1,0,1
4790,868,12,4,8,0,1,0,0
1131,95,6,2,4,0,3,0,0
202,1234,17,4,13,0,1,0,0
9589,1234,17,4,13,0,1,0,0
3900,769,20,9,11,0,5,0,0
9958,769,20,9,11,0,5,0,0
8955,49,4,1,3,1,5,0,0
10033,38,4,1,3,0,6,0,0
5751,38,4,1,3,0,6,0,0
3308,94,6,2,4,0,4,0,0
7297,57,7,3,4,0,7,0,0
8008,119,6,2,4,0,6,0,0
1232,1244,16,4,12,0,2,0,0
2345,1244,16,4,12,0,2,0,0
1628,960,16,9,7,0,4,0,0
5081,47,4,1,3,0,8,0,0
839,170,8,3,5,0,5,0,0
3706,94,6,2,4,1,7,0,1
5154,54,5,2,3,0,6,0,0
8584,1165,16,2,14,0,0,0,0
6583,981,20,6,14,1,3,0,0
3433,981,20,6,14,1,3,0,0
10486,990,16,4,12,0,2,0,0
8687,486,13,2,11,0,3,0,0
7842,74,6,3,3,0,8,0,0
3749,1580,23,6,17,0,3,0,0
1331,72,5,2,3,0,7,0,0
5995,384,13,6,7,0,8,0,1
8985,1211,27,10,17,0,6,0,0
2798,1240,26,7,19,3,4,0,1
7108,353,12,5,7,0,5,0,0
2781,1792,16,4,12,2,2,0,1
3623,45,7,4,3,0,7,0,0
194,41,4,1,3,0,6,0,0
10833,973,24,8,16,1,6,0,0
2315,96,5,1,4,0,4,0,0
6336,48,6,2,4,0,6,0,0
10738,65,5,2,3,0,7,0,0
8286,122,7,3,4,1,7,0,0
2166,23,3,0,3,0,4,0,0
10691,43,4,1,3,0,6,0,0
9739,114,6,2,4,0,7,0,0
1829,1232,18,9,9,1,7,0,1
6260,1957,26,3,23,1,1,0,1
10448,377,13,5,8,1,7,0,0
1343,586,16,8,8,0,7,0,0
4749,586,16,8,8,0,7,0,0
531,1662,22,8,14,0,6,0,1
6905,1004,20,6,14,0,2,0,0
1045,279,11,5,6,0,7,0,0
4012,1226,18,7,11,0,6,0,1
5529,444,15,8,7,1,7,0,0
4001,444,15,8,7,1,7,0,0
10420,222,9,4,5,0,7,0,0
7723,1440,20,8,12,0,3,0,0
2963,1440,20,8,12,0,3,0,0
10634,406,14,4,10,0,3,0,0
5180,149,8,4,4,0,7,0,0
6866,34,4,1,3,0,5,0,0
1328,683,17,4,13,0,3,0,0
1139,1512,21,5,16,3,2,0,1
4961,61,7,2,5,0,4,0,0
5177,396,14,6,8,0,6,0,0
2075,1047,15,3,12,0,1,0,0
3428,1598,23,4,19,0,2,0,0
4500,1598,23,4,19,0,2,0,0
7369,62,5,2,3,0,8,0,0
4381,235,10,3,7,0,6,0,0
9964,424,14,4,10,0,4,0,0
1630,424,14,4,10,0,4,0,0
5012,34,4,1,3,0,8,0,0
6918,34,4,1,3,0,8,0,0
7822,662,18,4,14,0,3,0,0
10156,1237,19,8,11,0,3,0,0
3033,318,10,2,8,0,3,0,0
4119,318,10,2,8,0,3,0,0
11110,5,0,0,0,0,14,0,0
332,275,11,4,7,1,6,0,0
737,2231,13,4,9,3,2,0,0
10319,1286,18,3,15,1,8,0,0
2683,910,22,6,16,0,6,0,0
3445,957,21,7,14,0,5,0,1
10913,27,3,1,2,1,8,0,1
4427,1365,27,5,22,2,6,1,1
8717,1835,27,11,16,0,5,0,0
2066,114,6,2,4,0,6,0,0
3340,436,14,7,7,0,8,0,1
8685,436,14,7,7,0,8,0,1
4149,1348,20,5,15,0,2,0,0
8726,174,8,3,5,0,6,0,0
2295,825,21,5,16,0,3,0,0
3283,909,20,6,14,0,3,0,0
1915,1507,19,8,11,0,3,0,0
800,32,4,1,3,0,4,0,0
9166,882,20,4,16,0,2,0,0
5147,1424,26,4,22,0,1,0,0
13,32,4,1,3,0,6,0,0
8724,46,5,2,3,0,6,0,0
9381,606,16,4,12,0,3,0,0
9384,606,16,4,12,0,3,0,0
3560,1574,19,4,15,1,1,0,0
241,1574,19,4,15,1,1,0,0
7521,1574,19,4,15,1,1,0,0
9799,1173,16,2,14,0,5,0,0
5123,143,6,2,4,0,7,0,0
448,795,19,6,13,0,5,0,0
4837,1305,26,8,18,0,4,0,0
9365,1277,19,11,8,0,6,0,0
8932,1531,21,9,12,0,6,0,0
7055,1021,24,8,16,0,5,0,0
3537,79,7,3,4,0,8,0,0
9081,25,4,1,3,0,5,0,0
4988,62,6,1,5,0,4,0,0
1050,65,7,2,5,0,2,0,0
5610,36,4,1,3,0,7,0,0
3526,38,4,1,3,0,7,0,0
5136,798,21,9,12,2,6,0,0
1411,940,15,2,13,0,1,0,0
701,1179,16,6,10,1,2,0,0
6203,1734,25,6,19,0,3,0,0
7192,545,16,2,14,0,1,1,0
5181,24,3,1,2,0,9,0,0
9220,1968,19,8,11,0,3,0,1
7734,1216,21,4,17,2,1,0,1
10446,729,16,5,11,3,2,0,1
5524,1617,22,8,14,0,7,0,1
3830,459,15,4,11,0,3,0,0
5186,731,20,7,13,1,6,0,0
8514,20,4,1,3,0,6,0,0
7165,823,20,8,12,0,5,0,0
10236,64,5,2,3,0,8,0,0
2392,102,6,3,3,0,7,0,0
1920,102,6,3,3,0,7,0,0
3673,779,23,7,16,0,5,0,0
1453,1060,25,9,16,0,6,0,0
4518,1169,25,9,16,0,5,0,0
8969,1141,21,5,16,0,3,0,0
387,61,5,2,3,0,8,0,0
1079,1086,16,3,13,1,8,0,0
164,269,11,5,6,0,8,0,0
3434,1336,18,4,14,0,1,0,0
5721,1566,23,7,16,1,2,0,0
8418,61,5,2,3,0,7,0,0
5300,70,5,2,3,0,7,0,0
10424,1295,17,4,13,0,1,0,0
11171,411,14,6,8,0,7,0,0
1600,411,14,6,8,0,7,0,0
7851,926,21,3,18,0,1,0,0
10701,1211,27,7,20,2,4,0,0
891,11,3,1,2,0,5,0,0
6912,772,21,6,15,0,4,0,0
5967,70,6,2,4,0,8,0,0
2109,1544,27,6,21,1,2,0,1
6292,1822,17,4,13,1,2,0,1
8537,1429,20,3,17,1,2,0,1
9576,159,8,4,4,0,9,0,0
5935,764,20,7,13,0,5,0,0
10264,31,4,1,3,1,7,0,1
234,31,4,1,3,1,7,0,1
3202,1250,18,4,14,2,8,0,0
1103,2053,18,4,14,2,6,0,1
610,480,15,7,8,0,8,0,0
4480,401,14,7,7,0,6,0,0
10660,438,14,8,6,1,7,0,0
9353,995,14,5,9,1,3,0,0
4120,369,11,6,5,0,7,0,0
2836,19,3,1,2,0,8,0,0
9579,106,6,2,4,0,8,0,0
5841,832,21,10,11,0,7,0,0
3174,1957,19,5,14,4,6,0,1
5536,1957,19,5,14,4,6,0,1
2061,99,6,2,4,1,6,0,0
8477,28,4,1,3,0,7,0,0
640,1026,23,7,16,0,5,0,0
3828,1327,26,7,19,0,4,0,0
4093,436,12,4,8,0,5,0,0
8624,928,17,4,13,0,2,0,0
2802,961,17,4,13,0,2,0,0
368,290,11,3,8,0,5,0,0
3599,1464,20,8,12,0,5,0,0
3389,1533,30,8,22,0,5,0,0
10710,18,3,1,2,0,8,0,0
7118,1528,20,9,11,1,6,0,1
4937,44,4,1,3,0,7,0,0
1127,1958,19,6,13,1,2,0,0
833,72,6,3,3,0,7,0,0
3565,72,6,3,3,0,7,0,0
6086,1380,23,6,17,1,2,0,0
1763,2524,28,7,21,3,4,0,1
4697,390,13,7,6,0,8,0,0
182,397,13,6,7,0,8,0,0
1165,496,15,6,9,0,6,0,0
5386,2302,18,5,13,3,2,0,1
6024,2302,18,5,13,3,2,0,1
2678,209,8,5,3,0,9,0,0
5790,72,5,2,3,0,8,0,0
236,170,7,2,5,0,6,0,0
6001,937,23,5,18,0,5,0,0
6250,775,21,11,10,0,8,0,1
1168,1401,20,4,16,0,2,0,0
10749,178,1,0,1,0,19,0,0
2926,1374,20,3,17,2,8,0,0
716,976,24,6,18,0,3,0,0
6544,976,24,6,18,0,3,0,0
4298,10,3,1,2,0,8,0,0
5823,39,5,1,4,0,5,0,0
8375,518,16,8,8,0,7,0,0
5723,116,7,1,6,0,2,0,0
5763,380,13,6,7,0,6,0,0
8727,1150,26,11,15,0,6,0,0
3056,1150,26,11,15,0,6,0,0
8442,30,4,1,3,0,7,0,0
3712,259,11,3,8,1,4,0,0
10722,546,15,6,9,1,6,0,0
2406,519,16,6,10,0,5,0,0
7313,1565,22,6,16,1,3,0,0
2656,59,4,1,3,0,7,0,0
1993,972,14,2,12,1,8,0,0
4136,119,7,3,4,0,9,0,0
2928,990,14,2,12,0,8,0,0
2920,990,14,2,12,0,8,0,0
6661,1174,27,9,18,0,6,0,0
5462,1174,27,9,18,0,6,0,0
10897,1174,27,9,18,0,6,0,0
10542,77,6,3,3,0,9,0,0
5756,55,5,2,3,0,6,0,0
3570,244,10,4,6,0,5,0,0
1072,93,6,2,4,0,6,0,0
9606,1536,12,4,8,2,3,0,1
2730,1231,17,3,14,0,1,0,0
2995,1084,16,3,13,0,1,0,0
8210,405,13,4,9,0,4,0,0
773,595,16,6,10,0,6,0,0
5272,562,16,8,8,0,7,0,0
5125,1348,25,4,21,0,2,0,0
4391,908,21,9,12,0,6,0,0
6283,908,21,9,12,0,6,0,0
3421,908,21,9,12,0,6,0,0
5731,37,4,1,3,0,7,0,0
7152,37,4,1,3,0,7,0,0
3919,1931,19,5,14,1,3,0,1
6097,561,15,8,7,0,9,0,0
5150,47,5,2,3,0,6,0,0
10479,1511,10,3,7,0,1,0,0
5966,215,10,3,7,1,6,0,0
3439,296,10,4,6,0,6,0,0
6609,107,6,3,3,0,9,0,1
5393,42,4,1,3,0,7,0,0
9014,61,6,3,3,0,8,0,0
4050,127,7,2,5,0,3,0,0
6862,8,0,0,0,0,20,0,0
8315,23,3,1,2,0,6,0,0
5184,23,3,1,2,0,6,0,0
3643,928,13,4,9,1,2,0,0
2589,59,6,2,4,0,6,0,0
4887,63,5,2,3,0,5,0,0
10104,8,3,1,2,0,7,0,0
3254,960,13,5,8,0,2,0,0
2004,1168,16,4,12,0,1,0,0
6142,900,13,5,8,0,2,1,0
8553,42,4,1,3,0,6,0,0
9805,660,18,6,12,0,4,0,0
849,660,18,6,12,0,4,0,0
1606,22,3,1,2,0,8,0,0
125,271,11,5,6,1,7,0,0
9305,1315,26,4,22,0,2,0,0
4706,40,4,1,3,0,5,0,0
4437,260,10,3,7,0,4,0,0
3081,20,3,1,2,0,7,0,0
3536,55,5,1,4,0,5,0,0
8686,75,5,2,3,0,8,0,0
9707,1182,17,4,13,2,8,0,0
10872,1182,17,4,13,2,8,0,0
9058,1867,21,5,16,3,3,0,1
4640,1079,24,4,20,0,2,0,0
2525,534,16,5,11,0,6,0,1
9503,313,11,5,6,0,8,0,0
10704,693,17,6,11,0,4,0,0
2669,1127,15,5,10,0,2,0,0
10037,1127,15,5,10,0,2,0,0
5680,30,4,1,3,0,6,0,0
3726,17,3,1,2,0,8,0,0
4548,54,4,1,3,0,4,0,0
4599,458,15,7,8,0,7,0,0
879,458,15,7,8,0,7,0,0
7409,267,11,4,7,0,5,0,0
1964,1603,17,5,12,0,2,0,0
0,1198,16,3,13,0,1,0,0
4860,25,4,1,3,0,6,0,0
425,727,19,6,13,0,5,0,0
9500,758,19,9,10,0,7,1,0
3074,1828,17,5,12,0,6,0,1
5140,1445,19,4,15,0,8,0,0
2611,1910,18,2,16,1,1,0,0
916,31,4,1,3,0,3,0,0
10413,1089,22,4,18,0,1,0,0
3696,52,5,2,3,0,7,0,0
304,76,6,3,3,0,7,0,0
5113,1702,15,5,10,1,2,0,1
4597,2018,18,3,15,0,1,0,0
675,332,11,4,7,0,7,0,0
4483,1228,18,2,16,0,1,0,0
1502,52,5,2,3,0,8,0,0
736,52,5,2,3,0,8,0,0
4487,95,6,2,4,0,6,0,1
3412,957,13,2,11,1,7,0,0
1744,54,4,1,3,0,6,0,0
5837,494,15,6,9,0,7,0,0
3422,1376,9,2,7,2,6,0,0
7462,570,16,10,6,0,9,0,0
10702,450,15,7,8,0,7,0,0
2115,66,5,1,4,1,5,0,0
4138,899,22,5,17,1,1,0,0
11091,22,4,1,3,0,4,0,0
7712,634,18,6,12,0,4,0,0
3535,967,12,4,8,0,2,0,0
5899,49,1,1,0,1,20,0,0
8749,61,4,1,3,0,4,0,0
10955,1600,13,3,10,0,1,0,1
9491,66,7,3,4,0,7,0,0
5286,217,9,3,6,0,3,0,0
3409,339,12,7,5,1,9,0,0
2544,92,6,1,5,0,1,0,0
2118,622,17,7,10,0,4,0,0
9370,1120,15,6,9,0,4,0,0
4864,175,8,4,4,0,8,0,0
405,441,13,5,8,1,8,0,0
10513,1502,11,2,9,1,7,0,0
5138,43,4,1,3,0,8,0,0
8387,235,10,4,6,0,6,0,0
378,794,19,7,12,0,6,0,0
5846,13,3,1,2,0,6,0,0
8870,497,12,6,6,0,8,0,1
10340,497,12,6,6,0,8,0,0
7290,968,20,3,17,0,2,0,0
8895,968,20,3,17,0,2,0,0
3635,578,17,6,11,0,5,0,0
11178,32,4,1,3,0,7,0,0
2410,1097,15,3,12,0,1,0,0
3281,411,13,4,9,0,6,0,0
9905,255,9,3,6,1,6,0,0
2565,1334,19,4,15,1,3,0,0
7912,103,6,3,3,1,8,0,0
7072,1335,17,8,9,0,4,0,0
1409,444,13,7,6,0,8,0,0
5314,444,13,7,6,0,8,0,0
7215,1135,27,6,21,3,2,0,1
8858,542,17,8,9,1,8,0,0
895,594,17,5,12,0,5,0,0
10313,254,10,5,5,0,8,0,0
642,103,5,2,3,0,8,0,0
8504,1366,18,5,13,1,2,0,0
1020,1366,18,5,13,1,2,0,0
3717,704,16,5,11,1,3,0,0
7646,805,20,5,15,0,4,0,0
5796,1125,22,4,18,1,1,0,0
8625,45,6,3,3,0,8,0,0
5407,1085,23,10,13,1,7,0,0
4356,1574,11,3,8,2,6,0,0
2886,1217,28,10,18,2,6,0,0
10057,1331,21,5,16,0,7,0,1
10741,319,12,6,6,0,7,0,0
5491,319,12,6,6,0,7,0,0
4442,177,7,1,6,0,3,0,0
3972,401,13,7,6,0,8,0,0
2431,67,5,2,3,0,8,0,0
7899,1680,15,4,11,0,7,0,0
9703,184,7,3,4,1,7,0,1
6927,264,11,5,6,0,8,0,0
7005,813,20,5,15,1,2,0,0
246,312,12,4,8,0,4,0,0
4796,39,4,1,3,0,2,0,0
4725,67,6,1,5,0,2,0,0
3286,42,5,2,3,0,6,0,0
10680,70,6,3,3,0,7,0,0
4297,40,5,2,3,0,8,0,0
7327,47,6,1,5,0,2,0,0
1553,2283,22,7,15,2,4,0,0
1665,1750,13,2,11,3,5,0,1
10640,211,9,4,5,0,7,0,0
7620,106,6,2,4,0,8,0,0
7761,109,7,3,4,0,6,0,0
5062,39,4,2,2,0,8,0,0
6349,1319,18,8,10,0,5,0,0
3386,137,7,2,5,0,7,0,0
8175,137,7,2,5,0,7,0,0
6245,507,16,3,13,0,3,0,0
8780,507,16,3,13,0,3,0,0
2276,868,22,4,18,0,3,0,0
1172,2034,24,7,17,3,3,0,1
3225,265,10,4,6,1,6,0,1
8629,41,4,1,3,0,5,0,0
798,27,4,1,3,0,7,0,0
269,1143,15,4,11,0,9,0,0
8213,96,7,2,5,0,7,0,1
10245,756,14,3,11,0,1,0,0
2447,69,5,2,3,0,7,0,0
9817,1049,25,9,16,0,8,0,0
1371,984,15,2,13,0,1,0,0
8093,914,13,4,9,1,1,0,0
713,442,14,4,10,0,3,0,0
11051,661,19,6,13,0,4,0,0
5545,988,13,3,10,0,1,0,0
5283,144,7,2,5,0,5,0,0
5010,34,4,1,3,0,8,0,0
7495,156,8,2,6,0,4,0,0
4368,134,7,3,4,0,6,0,0
6303,1497,22,5,17,0,1,0,0
1030,38,4,1,3,0,7,0,0
10364,20,3,1,2,0,8,0,0
6945,1375,31,9,22,0,5,0,0
8562,236,10,2,8,0,2,0,0
2918,91,6,2,4,0,5,0,0
9167,976,23,9,14,0,6,0,0
4743,971,23,8,15,0,6,0,0
10742,746,11,4,7,1,1,0,0
10965,1722,21,3,18,1,6,0,0
7129,929,23,6,17,0,6,0,0
3732,860,21,5,16,0,4,0,0
7124,94,7,2,5,0,5,0,0
10686,21,3,1,2,0,7,0,0
7247,606,17,7,10,1,6,0,0
1513,1250,16,2,14,0,8,0,0
460,1753,16,3,13,0,2,0,0
6653,418,14,7,7,0,7,0,1
9400,1383,18,6,12,0,2,0,0
7106,1242,18,3,15,0,1,0,0
4252,301,11,4,7,0,5,0,0
9240,526,16,6,10,0,6,0,0
10770,1045,24,4,20,0,2,0,0
176,331,11,4,7,0,3,0,0
6870,283,11,3,8,0,2,0,0
143,957,12,5,7,0,2,0,0
6445,858,15,4,11,0,2,0,0
4278,1923,18,10,8,0,3,0,1
6906,1024,17,3,14,3,2,0,1
4637,1650,24,6,18,1,3,0,0
8690,1385,22,5,17,0,2,0,0
1173,2252,12,4,8,2,2,0,1
1928,83,5,2,3,1,9,0,0
9029,1536,22,2,20,0,1,0,0
10299,882,22,6,16,0,5,0,1
9246,415,13,6,7,0,7,0,0
4943,1727,15,2,13,2,6,0,0
4122,895,15,6,9,1,4,0,1
2853,275,10,4,6,0,5,0,0
902,312,12,6,6,0,6,0,0
1672,461,14,5,9,0,2,0,0
7254,137,7,3,4,0,7,0,0
8775,137,7,3,4,0,7,0,0
9543,22,3,0,3,0,7,0,0
7093,22,3,0,3,0,7,0,0
2894,2013,20,7,13,3,4,0,1
5956,284,11,6,5,0,8,0,0
1921,71,5,2,3,0,4,0,0
5057,611,18,4,14,0,2,0,0
10260,311,12,6,6,0,7,0,0
2262,311,12,6,6,0,7,0,0
7930,268,10,3,7,0,6,0,0
1461,38,5,2,3,0,7,0,0
7514,177,8,3,5,0,6,0,0
6461,946,22,5,17,1,2,0,0
257,1215,18,5,13,0,3,0,0
9460,162,7,3,4,0,8,0,0
3855,162,7,3,4,0,8,0,0
367,577,15,9,6,0,9,0,0
9265,1390,19,9,10,0,5,0,0
1990,1797,16,3,13,1,3,0,0
3594,747,19,8,11,0,8,0,0
9292,1382,22,4,18,0,2,0,0
6218,499,16,8,8,1,7,0,0
6528,10,3,1,2,0,8,0,0
10164,1691,15,5,10,2,5,0,0
9937,576,16,2,14,0,1,0,0
274,34,5,2,3,0,6,0,0
11010,44,6,3,3,0,8,0,0
6969,233,10,4,6,0,7,0,0
10735,26,4,2,2,0,9,0,0
5068,26,4,2,2,0,9,0,0
9974,70,6,3,3,0,7,0,0
7053,1453,21,3,18,0,1,0,0
3179,1572,19,6,13,0,2,0,0
8082,34,4,1,3,0,7,0,1
1362,449,13,6,7,0,7,0,0
6768,36,4,1,3,0,8,0,0
2375,22,3,0,3,0,8,0,0
6856,65,6,3,3,0,9,0,1
4066,46,5,2,3,0,6,0,0
4333,54,6,2,4,1,7,0,0
2948,185,9,2,7,0,2,0,0
4927,68,6,3,3,0,9,0,0
7426,198,9,3,6,0,3,0,0
8360,198,9,3,6,0,3,0,0
4058,811,21,11,10,1,6,0,0
10755,81,6,3,3,0,7,0,0
8414,86,6,2,4,0,7,0,0
6810,1187,11,3,8,1,1,0,1
3839,88,7,2,5,0,5,0,0
3483,1526,22,2,20,3,8,0,1
238,1082,24,9,15,0,7,0,0
591,677,18,8,10,0,7,0,0
5063,191,9,4,5,0,9,0,0
4303,137,1,0,1,0,20,0,0
2258,42,4,1,3,0,8,0,0
7301,79,6,3,3,0,8,0,1
11121,70,7,4,3,0,9,0,0
5287,79,7,3,4,0,7,0,0
6457,902,22,6,16,0,4,0,0
3559,57,6,2,4,0,6,0,0
5577,23,3,1,2,0,6,0,0
641,119,6,2,4,1,4,0,0
954,102,6,2,4,0,5,0,0
1834,67,5,2,3,0,7,0,0
8789,274,11,3,8,0,4,0,0
10584,945,23,5,18,0,3,0,0
2337,39,6,3,3,0,6,0,0
6071,1157,21,3,18,0,1,0,0
295,1157,21,3,18,0,1,0,0
10203,42,4,1,3,0,7,0,0
3968,1199,26,11,15,3,7,0,1
4037,20,3,1,2,0,7,0,0
6932,2119,22,7,15,1,2,0,0
10159,1185,25,11,14,0,6,0,0
1177,129,7,3,4,0,7,0,0
9426,900,11,2,9,0,8,0,0
10637,99,6,3,3,0,7,1,0
10826,60,4,1,3,0,8,0,0
4086,60,4,1,3,0,8,0,0
10304,60,4,1,3,0,8,0,0
7998,112,6,2,4,0,7,0,0
10992,1148,21,4,17,0,8,0,0
6383,46,6,3,3,0,8,0,0
10536,46,6,3,3,0,8,0,0
6036,1924,18,5,13,1,1,0,0
11092,41,5,2,3,0,7,0,0
538,125,6,1,5,0,3,0,0
10022,16,3,1,2,0,5,0,0
10157,274,11,4,7,0,4,0,0
3503,974,14,5,9,0,1,0,0
146,1323,20,4,16,1,2,0,0
5538,1862,17,4,13,3,1,0,1
3910,1862,17,4,13,3,1,0,1
4227,55,6,2,4,0,5,0,0
6634,54,5,2,3,0,7,0,0
8916,16,3,0,3,0,5,0,0
6460,57,5,2,3,0,8,0,0
5883,664,18,7,11,0,5,0,0
10091,1067,15,6,9,0,5,0,0
697,2047,20,5,15,1,3,0,0
2607,630,18,8,10,0,8,0,0
8427,1540,22,7,15,0,4,0,0
217,1540,22,7,15,0,4,0,0
6202,1005,22,4,18,0,2,0,0
3856,1005,22,4,18,0,2,0,0
10648,1289,18,5,13,0,3,0,0
5120,1289,18,5,13,0,3,0,0
6749,1722,14,5,9,0,8,0,0
1584,482,14,8,6,0,8,0,0
9559,1034,25,7,18,1,5,0,0
771,194,9,2,7,0,2,0,0
5237,63,6,2,4,0,5,0,0
2461,43,4,1,3,0,3,0,0
5474,223,9,4,5,0,6,0,0
2895,195,9,3,6,0,5,0,0
7972,1151,16,3,13,0,1,0,0
10067,13,3,1,2,0,7,0,0
500,1941,23,7,16,3,2,0,1
922,48,4,1,3,1,8,0,0
2861,23,3,1,2,0,8,0,0
375,1156,15,2,13,0,1,0,0
10936,1947,15,5,10,0,3,0,0
10314,1318,24,9,15,2,4,0,1
4240,58,5,2,3,0,8,0,0
2674,1143,15,6,9,0,3,0,1
2563,43,5,2,3,0,6,0,0
8312,43,5,2,3,0,6,0,0
6999,834,22,7,15,0,3,0,0
7574,41,5,2,3,0,4,0,0
5223,66,6,2,4,0,4,0,0
2952,76,6,3,3,0,6,0,0
7683,787,20,5,15,0,3,0,0
9481,68,7,3,4,0,8,0,0
9907,1013,24,6,18,0,4,0,0
5454,50,5,2,3,0,5,0,0
3798,81,6,2,4,0,6,0,0
4259,10,3,1,2,0,7,0,0
2549,27,4,1,3,0,9,0,0
6437,76,5,2,3,0,7,0,0
2488,64,6,2,4,0,6,0,0
3945,930,23,11,12,1,6,0,1
702,521,15,4,11,0,5,0,0
9010,2346,22,5,17,3,2,0,1
9710,792,21,11,10,0,8,0,0
1509,523,22,9,13,4,5,0,1
9120,1065,15,4,11,0,8,0,0
5252,67,5,2,3,0,7,0,0
5959,199,9,3,6,0,8,0,0
7441,1615,24,2,22,0,7,0,0
4271,341,11,4,7,0,7,0,0
4095,467,13,4,9,0,7,0,0
8852,1080,23,8,15,0,6,0,0
7698,191,9,4,5,0,5,0,0
4174,130,7,2,5,0,3,0,0
3182,263,9,5,4,1,8,0,1
193,16,3,1,2,1,5,0,0
5229,42,4,1,3,0,7,0,0
5555,6,0,0,0,0,0,0,0
7732,745,19,7,12,0,5,0,0
310,573,17,4,13,0,4,0,0
6261,470,15,3,12,0,4,0,0
6274,1615,24,8,16,2,3,0,0
1655,48,4,1,3,0,7,0,0
2740,90,7,2,5,0,5,0,0
4328,55,6,2,4,0,6,0,0
17,1028,24,6,18,0,5,0,0
9153,1048,25,7,18,0,5,0,0
520,30,3,1,2,0,7,0,0
8372,30,3,1,2,0,7,0,0
73,18,3,0,3,0,5,0,0
2002,1870,16,5,11,0,3,0,0
6059,1314,18,11,7,0,7,0,1
11166,315,12,6,6,0,7,0,0
6257,507,16,7,9,0,7,0,0
9224,1139,23,8,15,0,6,0,0
8732,1461,21,7,14,2,4,0,1
955,240,10,4,6,1,8,0,1
4910,2074,29,11,18,0,7,0,0
564,906,23,8,15,1,6,0,1
8931,1761,25,11,14,1,5,0,0
1998,84,6,2,4,0,6,0,0
1250,84,6,2,4,0,6,0,0
8397,34,4,1,3,1,7,0,0
9672,65,5,1,4,0,6,0,0
2125,1102,15,3,12,0,2,0,0
5975,57,5,2,3,0,7,0,0
983,414,11,6,5,1,8,0,0
9938,1600,16,4,12,1,2,0,0
4385,47,6,3,3,0,6,0,0
803,21,3,0,3,0,5,0,0
10675,1161,17,9,8,0,5,0,1
7004,84,6,3,3,1,9,0,0
4432,51,5,2,3,0,7,0,0
4475,2440,24,7,17,0,5,0,0
10868,1272,17,3,14,0,3,0,0
6742,11,3,1,2,0,8,1,0
5692,32,4,1,3,0,8,0,0
339,496,16,9,7,1,7,0,1
10398,31,3,1,2,0,7,0,0
8017,55,5,2,3,0,6,0,0
3722,48,5,2,3,0,6,0,0
7326,63,5,1,4,0,2,0,0
2416,1288,19,2,17,0,1,0,0
1878,37,5,2,3,0,7,0,0
5278,902,20,6,14,1,3,0,0
5734,91,6,2,4,0,5,0,0
4370,88,6,2,4,0,6,0,0
8405,305,11,4,7,0,3,0,0
7617,163,8,2,6,0,5,0,0
6376,545,15,4,11,0,4,0,0
2150,1482,21,8,13,0,4,0,0
7386,43,4,1,3,0,7,0,0
3006,43,4,1,3,0,7,0,0
11088,1816,17,4,13,0,6,0,0
5185,892,12,4,8,0,2,0,0
3523,1073,17,5,12,0,3,0,0
55,597,18,7,11,0,6,0,0
3807,766,20,9,11,0,6,0,0
2453,819,20,5,15,0,5,0,0
7787,819,20,5,15,0,5,0,0
2230,43,7,3,4,0,5,0,0
8146,54,4,1,3,0,6,0,0
988,1193,17,6,11,1,3,0,0
4832,101,6,2,4,0,7,0,0
3152,89,6,2,4,0,5,0,0
11188,89,6,2,4,0,5,0,0
361,20,3,1,2,0,7,0,0
5939,122,7,3,4,0,5,0,0
9349,1131,22,6,16,2,2,0,0
819,1103,24,6,18,0,3,0,0
10120,257,10,3,7,0,5,0,0
4541,257,10,3,7,0,5,0,0
2456,149,8,2,6,0,6,0,0
2516,78,5,1,4,0,4,0,0
11013,938,16,2,14,0,1,0,0
9988,860,22,6,16,0,4,0,0
1627,789,21,5,16,1,4,0,0
1490,854,21,10,11,0,8,0,0
6710,103,6,2,4,0,6,0,0
7375,576,14,8,6,0,8,0,0
10144,576,14,8,6,0,8,0,0
3138,1676,22,7,15,4,4,0,1
1440,1149,23,9,14,0,7,0,0
4200,275,11,4,7,0,5,0,0
4998,1033,13,4,9,1,2,0,0
7321,1033,13,4,9,1,2,0,0
8663,15,3,1,2,0,6,0,0
1958,660,19,8,11,0,5,0,0
6963,1157,17,2,15,1,1,0,0
1065,1918,18,5,13,0,2,0,0
2712,715,19,6,13,0,3,0,0
6049,1804,26,7,19,2,3,0,0
6605,682,19,9,10,1,7,0,0
11181,8,0,0,0,0,0,0,0
5234,81,5,1,4,0,5,0,0
5253,227,10,4,6,0,7,0,0
11148,13,3,1,2,0,8,0,0
6289,185,8,3,5,0,5,0,0
9743,1910,27,11,16,1,6,0,0
9209,1564,23,4,19,0,2,0,0
6417,1564,23,4,19,0,2,0,0
7937,58,6,3,3,0,7,0,0
6488,99,7,3,4,0,5,0,0
3194,1230,18,4,14,0,1,0,0
231,32,5,2,3,0,5,0,0
9697,542,17,7,10,0,6,0,0
4676,1695,23,9,14,0,5,0,0
8079,55,6,2,4,0,3,0,0
10032,53,7,3,4,0,6,0,0
10505,1001,14,3,11,0,2,0,0
2005,75,6,2,4,0,6,0,0
6940,223,8,3,5,1,6,0,0
2304,770,21,6,15,0,4,0,0
3170,1042,14,4,10,0,2,0,0
10466,60,5,1,4,0,4,0,0
7325,40,4,1,3,0,5,0,0
455,209,9,4,5,0,6,0,0
7592,209,9,4,5,0,6,0,0
4547,25,4,1,3,0,8,0,0
6825,16,3,1,2,0,7,0,0
2961,382,13,6,7,1,6,0,0
8700,66,6,2,4,0,7,0,0
2278,133,6,2,4,0,6,0,0
10703,120,7,3,4,0,8,0,0
9,120,7,3,4,0,8,0,0
2804,120,7,3,4,0,8,0,1
4915,732,19,5,14,0,5,0,0
3010,2069,19,4,15,3,1,0,0
4279,54,5,1,4,0,3,0,0
2564,165,8,3,5,0,6,0,0
1137,1379,16,4,12,2,1,0,0
5084,1064,23,6,17,0,4,0,0
7094,1064,23,6,17,0,4,0,0
6327,1146,16,2,14,0,1,0,0
6131,431,14,4,10,0,3,0,0
10379,574,16,5,11,0,6,0,0
606,15,3,1,2,0,7,0,0
7801,728,18,5,13,0,4,0,0
2445,63,5,2,3,0,8,0,0
5346,79,6,3,3,0,7,0,0
550,708,19,3,16,0,2,0,0
4478,653,18,11,7,0,8,0,0
2350,1027,13,3,10,1,8,0,0
1118,685,19,10,9,1,8,0,0
1491,559,14,3,11,0,1,0,0
4507,1250,21,6,15,0,3,0,0
7023,263,11,6,5,0,9,0,0
6977,1921,28,10,18,1,6,0,0
4042,180,8,4,4,0,8,0,1
7274,2153,21,4,17,1,2,0,0
3332,165,8,3,5,0,8,0,0
7433,165,8,3,5,0,8,0,0
9386,320,12,5,7,1,6,0,0
5176,53,4,1,3,1,9,0,0
10323,304,11,4,7,0,5,0,0
4682,310,12,2,10,0,1,0,0
3083,373,13,6,7,0,7,0,0
8015,1313,19,4,15,0,1,0,1
1745,1313,19,4,15,0,1,0,1
3136,663,19,5,14,0,5,0,0
6991,637,18,9,9,0,8,0,0
8132,661,19,9,10,1,7,0,0
503,53,5,2,3,0,8,0,0
8148,859,20,6,14,0,5,0,0
2736,849,21,5,16,0,2,0,0
8162,26,4,1,3,0,6,0,0
692,16,3,1,2,0,6,0,0
7706,1048,24,11,13,1,8,0,0
9298,1798,17,4,13,2,1,0,0
2986,20,3,1,2,0,6,0,0
10812,90,6,2,4,0,4,0,0
2909,1264,18,8,10,2,3,0,0
6974,1497,21,6,15,0,2,0,0
9140,91,6,2,4,0,6,0,0
4554,448,13,3,10,0,4,0,0
7791,25,4,1,3,0,7,0,0
5455,122,7,2,5,0,7,0,0
7960,1382,25,3,22,1,1,0,0
3426,1596,23,5,18,0,8,0,0
5316,84,6,2,4,0,7,0,0
1404,231,9,5,4,0,9,0,0
10598,37,5,2,3,0,8,0,0
8212,174,8,3,5,0,7,0,0
3233,1117,26,7,19,0,5,0,0
7892,75,6,2,4,0,7,0,0
2975,1956,22,6,16,1,3,0,0
5043,434,11,4,7,0,7,0,0
3104,2006,20,5,15,1,2,0,1
10854,45,5,2,3,0,7,0,0
7419,35,5,2,3,0,6,0,0
5558,1685,14,4,10,1,1,0,0
832,747,20,8,12,0,5,0,0
4964,1158,17,2,15,0,1,0,0
11030,16,3,1,2,1,6,0,0
4587,266,11,3,8,0,3,0,0
450,270,9,1,8,0,3,0,0
11031,40,4,1,3,0,5,0,0
4990,869,20,11,9,0,7,0,0
221,242,9,3,6,0,6,0,0
4351,55,4,1,3,1,7,0,0
1357,1562,12,2,10,0,5,0,0
5667,1701,23,9,14,0,6,0,1
8867,2126,19,4,15,0,3,0,0
2747,2126,19,4,15,0,3,0,0
7422,369,13,5,8,0,7,0,0
4148,348,12,5,7,0,8,0,0
9516,1229,26,9,17,2,7,0,1
1291,351,12,6,6,0,8,0,0
1833,133,7,2,5,0,5,0,0
7270,1241,18,2,16,1,6,0,0
8182,121,7,3,4,0,8,0,0
10394,1479,17,4,13,3,1,0,0
1142,428,14,3,11,0,3,0,0
451,22,4,1,3,0,8,0,0
7128,15,3,1,2,0,7,0,0
10678,917,23,11,12,0,7,0,0
7755,411,14,9,5,0,8,0,0
4754,122,6,2,4,0,4,0,0
20,183,7,2,5,0,4,0,0
2246,183,7,2,5,0,4,0,0
10307,525,16,6,10,0,5,0,0
2147,2279,22,4,18,2,2,0,0
10590,1483,22,4,18,0,2,0,0
6565,1782,24,11,13,1,5,0,0
6619,44,4,1,3,0,7,0,0
4817,18,3,1,2,0,8,0,0
4508,833,18,2,16,0,1,0,0
4843,833,18,2,16,0,1,0,0
9197,47,5,2,3,0,5,0,0
6237,416,25,23,2,0,0,0,0
6515,50,5,2,3,0,4,0,0
5954,192,9,5,4,0,8,0,0
7938,449,15,3,12,0,3,0,0
961,860,15,7,8,0,4,0,0
1764,270,11,5,6,0,8,0,0
1916,437,14,7,7,0,7,0,0
6941,95,5,2,3,0,7,0,0
5562,735,19,7,12,0,6,0,0
1517,51,4,1,3,0,7,0,0
7286,55,4,2,2,0,10,0,0
4687,1633,23,3,20,0,1,0,0
5631,692,17,5,12,0,4,0,0
1951,839,21,11,10,0,9,0,0
123,993,13,4,9,0,2,0,0
9451,1658,23,10,13,0,7,0,0
7396,1597,25,5,20,1,3,0,0
3298,1152,24,9,15,0,8,0,0
6730,54,5,2,3,0,8,1,0
9916,54,5,2,3,0,8,1,0
2227,210,9,3,6,0,6,0,0
946,210,9,3,6,0,6,0,0
3745,103,6,3,3,0,8,0,0
4094,289,11,5,6,0,6,0,0
8588,289,11,5,6,0,6,0,0
3916,890,22,7,15,0,7,0,0
9135,64,4,1,3,0,8,0,0
1755,114,6,1,5,0,3,0,0
2875,906,23,3,20,0,2,1,0
2008,1149,18,4,14,1,2,0,0
10925,1003,24,3,21,0,1,0,0
1604,225,10,2,8,0,5,0,0
5389,347,13,6,7,1,7,0,0
2878,414,13,4,9,0,3,0,0
4440,546,17,8,9,1,7,0,0
1324,91,6,3,3,0,8,0,0
6262,1573,21,3,18,0,2,0,0
3628,80,5,2,3,0,9,0,0
3641,36,5,2,3,0,6,0,0
322,41,5,2,3,0,4,0,0
175,1443,20,8,12,2,4,0,0
6988,1443,20,8,12,2,4,0,0
8204,1319,17,4,13,0,2,0,0
7476,1269,19,5,14,1,4,0,0
5221,879,22,10,12,1,8,0,0
8970,530,15,6,9,0,5,0,0
9286,747,18,5,13,0,3,0,0
5831,1815,15,5,10,2,8,0,1
1010,78,5,1,4,0,3,0,0
11074,1423,17,3,14,0,0,0,0
5896,397,14,4,10,0,2,0,0
3515,160,8,4,4,0,5,0,0
5324,422,14,5,9,0,5,0,0
6534,67,5,2,3,0,5,0,0
8373,29,4,1,3,0,5,0,0
3829,29,4,1,3,0,5,0,0
4501,1478,19,3,16,0,1,0,0
4179,55,5,1,4,0,4,0,0
2292,24,4,1,3,0,5,0,0
9239,126,7,2,5,0,3,0,0
8953,35,4,1,3,0,8,0,0
10258,35,4,1,3,0,8,0,0
3520,1092,14,4,10,4,3,0,1
10402,39,4,1,3,0,8,0,0
11114,84,6,2,4,0,7,0,0
9553,15,3,0,3,0,6,0,0
6055,1305,18,5,13,1,3,0,0
4786,1109,25,10,15,0,6,0,0
5015,162,7,2,5,0,7,0,0
8560,680,17,6,11,0,6,0,0
3469,103,6,3,3,0,9,0,0
5885,211,9,4,5,0,8,0,0
3310,211,9,4,5,0,8,0,0
2134,694,18,5,13,0,5,0,0
2532,1651,12,2,10,1,5,0,0
2579,835,22,6,16,0,4,0,0
5623,51,4,1,3,1,7,0,0
4789,1677,17,4,13,3,2,0,0
9523,15,3,0,3,0,4,0,0
5268,56,5,1,4,0,7,0,0
1545,443,14,7,7,0,8,0,0
2254,1455,20,9,11,0,5,0,0
2661,44,6,2,4,0,5,0,0
3130,44,6,2,4,0,5,0,0
5847,882,20,7,13,0,5,0,0
5863,655,17,6,11,0,5,0,0
999,730,24,6,18,2,3,0,1
2931,1192,22,6,16,1,3,0,0
1890,25,3,1,2,0,7,0,0
5589,793,21,9,12,0,7,0,0
10172,1538,20,4,16,0,3,0,0
6729,1538,20,4,16,0,3,0,0
10492,10,3,0,3,0,2,0,0
2939,1631,14,4,10,0,2,0,0
5948,237,10,4,6,0,5,0,0
574,125,6,1,5,0,2,0,0
3266,125,6,1,5,0,2,0,0
10500,98,7,3,4,0,5,0,0
7987,460,15,8,7,1,6,0,0
1135,47,7,3,4,0,7,0,0
24,47,7,3,4,0,7,0,0
1966,1672,25,6,19,1,2,0,0
7789,1672,25,6,19,1,2,0,0
3336,948,11,2,9,1,7,0,0
5644,363,13,5,8,1,7,0,0
6663,157,8,3,5,0,5,0,0
10262,53,7,3,4,0,5,0,0
456,36,5,2,3,0,8,0,0
3270,128,7,3,4,0,9,0,0
5748,475,13,5,8,0,5,0,1
8952,859,21,6,15,0,3,0,0
3921,205,9,4,5,0,8,0,0
9826,2114,21,5,16,0,2,0,1
5830,2114,21,5,16,0,2,0,1
8310,1459,21,10,11,0,6,0,0
6382,54,4,1,3,0,4,0,0
8439,902,13,6,7,1,4,0,0
7613,326,12,5,7,0,6,0,0
48,184,8,4,4,1,6,0,0
5046,1638,23,10,13,0,4,0,0
3231,30,4,1,3,0,8,0,0
7181,52,5,2,3,0,8,0,0
1663,49,4,2,2,0,9,0,0
5441,388,13,5,8,0,5,0,0
8602,1049,24,7,17,0,4,0,0
9925,216,9,4,5,1,7,0,0
9499,1616,14,3,11,2,5,0,0
6568,79,5,2,3,0,7,0,0
3032,193,8,4,4,0,9,0,0
5153,1529,32,11,21,1,6,0,1
4127,1529,32,11,21,1,6,0,1
9940,1009,14,6,8,0,3,0,0
7527,76,6,2,4,0,8,0,0
3406,322,12,3,9,0,3,0,0
9771,269,11,5,6,0,9,0,0
6722,767,20,10,10,0,6,0,0
213,48,6,2,4,0,7,0,0
8541,41,6,2,4,0,5,0,0
8475,1608,22,0,22,0,0,0,0
8070,264,11,3,8,0,3,0,0
313,2088,21,6,15,1,3,0,0
9757,1631,23,5,18,3,2,0,0
2088,1631,23,5,18,3,2,0,0
2320,635,18,11,7,0,9,0,0
966,691,19,6,13,1,5,0,0
9706,94,6,2,4,0,8,0,0
3979,1779,16,6,10,1,2,0,1
5602,1282,27,8,19,0,3,0,0
2202,69,5,1,4,0,5,0,0
9645,1338,23,9,14,0,6,0,0
7230,493,16,4,12,1,6,0,1
5675,493,16,4,12,1,6,0,0
4974,1392,19,4,15,0,7,0,0
5687,1633,26,7,19,0,3,0,0
5871,467,13,6,7,0,8,0,0
3846,270,11,6,5,0,8,0,0
10001,100,6,2,4,0,9,0,0
2831,1179,24,7,17,0,3,0,0
868,65,5,2,3,0,6,0,0
7212,65,5,2,3,0,6,0,0
1743,801,10,2,8,0,1,0,0
2415,953,13,5,8,1,4,0,0
7947,37,4,1,3,0,5,0,0
2106,34,4,1,3,0,8,0,0
3363,34,4,1,3,0,8,0,0
8595,67,5,1,4,0,5,0,0
7232,67,5,1,4,0,5,0,0
7829,65,5,2,3,0,5,1,0
9977,734,17,9,8,0,4,0,0
10142,689,18,5,13,0,4,0,0
5263,55,4,1,3,0,8,0,0
22,309,12,6,6,0,8,0,0
528,1383,19,5,14,0,3,0,0
4070,1078,17,8,9,2,7,0,1
